home: home
block: block blocks
file: file files
object: object
disk: disk
tape: tape
flash: flash
nvme: nvme
scm: scm
hci: hci
compos: composable
search: search regard
newslett: newsletter
regist: register
devclass: devclass
platform: platform
uncategor: uncategorized
catalog: catalog
demo: demos
massiv: massively learning
parallel: parallel
dna: dna
storag: storage
chri: chris
mellor: mellor
decemb: december
twitter: twitter
whatsapp: whatsapp
linkedin: linkedin
reddit: reddit
email: email
pioneer: pioneer
technolog: technologies sequencing
histor: a
breakthrough: historic
demonstr: breakthrough track advantages
data: demonstrating
store: data
updat: stored
explain: update
comput: explained helped
capabl: computing develop
increas: capabilities
effici: increase
cost: efficiency
effect: cost
read: effectiveness amount
order: reading
magnitud: orders
develop: magnitude seagate events users
base: developing
encod: based reality
section: encoding
synthet: sections
produc: synthetically
molecul: produced method
group: molecule
slower: groups
method: slower
write: molecules equates
potenti: writing moment
lab: potentially
chip: lab
sequenc: chip read
partner: technology work
seagat: partnering
hyunjun: capability
park: hyunjun
founder: park
ceo: founder
statement: ceo
transform: statement
achiev: transformational
year: achievement
work: years datasets
collabor: partners
help: collaborators
realiti: computation tale
approxim: encoded
word: approximately query
shakespear: words
s: shakespeare
hamlet: s
minut: hamlet
shannon: minutes
system: shannon analysis
pre: system
process: pre chemical
index: processing
carri: indexing
ran: carried
keyword: ran
retriev: keyword
occurr: retrieved
queri: occurrences
number: word
step: number
requir: steps
dataset: required massive
million: dataset
due: million
chemic: due message
sampl: processes
rehydr: sample
involv: rehydration
inher: involved
track: inherently
scalabl: demonstrate
set: scalability
mid: sets
advantag: mid
turn: demonstrated
attent: turn
address: attention
sophist: addressing
applic: sophisticated
signal: applications
machin: signal
learn: machine
close: working
reduc: closely
size: reduce
complex: size
identifi: complexity
specif: identify
workload: specific
target: workloads sequencer
commerci: target
offer: commercial
call: offerings
semiconductor: calling
add: semiconductor
processor: add
aspect: processor
case: aspect
amaz: case
scientif: amazing
start: scientific
build: start
life: building
plan: life
archiv: plans
ocient: archives
hyperscal: ocient
analysi: hyperscale
mail: systems
messag: mailed
amount: chemically
term: targeted io
present: term
result: presented expect
net: resultant
speed: netted
courtesi: speed
avoid: courtesy
percent: avoiding
contrast: percent
convent: contrasts
decod: conventional
ascertain: decode
content: ascertain
test: content
shown: tests
expect: shown
gener: result
regard: generally
total: searched
improv: total
arbitrari: improvement
area: arbitrary
receiv: area
ai: receiving
semant: ai
searcher: semantic
nuclia: searchers
reli: nuclia
moment: relies
capac: potential
give: capacity
physic: giving
space: physical
ssd: space
match: ssd
exabyt: match
zettabyt: exabytes
fashion: zettabytes
leg: fashion
bootnot: legs
slow: bootnote
io: slow
x: terms
letter: x
equat: letter
rate: write
byte: rate
sec: bytes
tag: sec
previou: tags
articl: previous related
new: article
ticker: news
backblaz: ticker
predict: backblaze
hdd: predicts
price: hdd
fall: prices
gb: fall
relat: gb
author: articles
samsung: author
forecast: samsung
petabyt: forecasts
decad: petabyte
micron: decade
bump: micron
bottom: bumps
memori: bottom
trough: memory
march: trough
reram: march
state: reram
plai: state
sage: play
stephen: sage
kelli: stephen
slam: kelly
wandisco: slams
board: wandisco
govern: board
tale: governance
women: realities
tech: women
balanc: tech
progress: balancing
backlash: progress
inform: backlash
site: information
cover: site
media: covering
devic: media
drive: devices
arrai: drives
server: arrays
cloud: server
network: cloud
protocol: networking
manag: protocols
supplier: management
standard: suppliers
publish: standards situation
view: publish
opinion: views
industri: opinions
event: industry
aim: developments
user: aiming
consult: developers
market: consultants
salespeopl: marketeers
support: salespeople
staff: support
analyst: staff
date: analysts
follow: date
contribut: follow
contact: contribute
sale: contact
privaci: sales
cooki: privacy
ts: cookies
cs: ts
sell: cs
person: sell
situat: personal
stori: publishing
biz: stories
nasuni: biz
ey: nasuni
intellig: eyes
april: intelligence
ultraram: april
class: ultraram
uk: class
edit: uk
live: edit
css: live
div: css
td: div
templat: td
widget: template
imag: widget
style: image
margin: style
left: margin
px: left
save: px
hit: save
ctrl: hit
auto: ctrl
complet: auto
