хабр: хабр
откр: открыть
список: список
стат: стать статьи статей статье статья
автор: автором авторы сайта
поток: потоки потока поток карты
разработк: разработка разработкой разработки разработке
администрирован: администрирование
дизайн: дизайн дизайном дизайну атомарной
менеджмент: менеджмент
маркетинг: маркетинг
научпоп: научпоп
поиск: поиск
профил: профиль
обнов: обновить
новост: новости
хаб: хабы
компан: компании компанией компания авторов
подряд: подряд
скопирова: скопировать
ссылк: ссылку ссылками
показыва: показывать визуализации
нов: новые новую
лучш: лучшие лучшего лучшее
порог: порог
рейтинг: рейтинга рейтинг
уровен: уровень
сложност: сложности
прост: простой простым
средн: средний
сложн: сложный сложного сложно сложные
примен: применить
час: час часов часа
демосц: демосцена демосцены
релейн: релейном релейный
компьютер: компьютере компьютер
прочтен: прочтение
мин: мин
количеств: количество пример
просмотр: просмотров просмотра
ненормальн: ненормальное
программирован: программирование программирования
работ: работа работы работу работе
виде: видео
график: графикой
туториа: туториал
обрат: обратимся
классик: классике
мо: моего моем мою моих
визит: визита
удивля: удивлялся
голосован: голосования
непонятн: непонятно
стольк: столько
люд: людей
отдава: отдавать отдавали
голос: голоса голосов
состоя: состоящие
туп: тупой
последовательн: последовательности
эффект: эффектов
плазм: плазмы
туннел: туннеля
огн: огня
куб: куба
подобн: подобных подобной
вещ: вещей
объединен: объединенных
никак: никаким никакой
сюжет: сюжетом
несущ: несущими
ид: идеи
возьм: возьм
попа: попавшийся попалась
понадела: понаделаем
чита: читать читаю
дал: далее
добав: добавить
закладк: закладки
комментар: комментарии комментариями
электронщик: электронщиков
анатом: анатомия
кана: канала
передач: передачи
блог: блог
интерфейс: интерфейсы интерфейсу интерфейса
производств: производство производству
электроник: электроники
компьютерн: компьютерное
желез: железо железе
сдела: сделай сделали сделан сделано процессом
перевод: перевод
предыдущ: предыдущий предыдущем
разбира: разбирали разбираются разбираться
дифпар: дифпары
основ: основы
прав: правила
разводк: разводки
известн: известные
допуск: допуски
отношен: отношении
поговор: поговорим поговорить
конкретн: конкретных конкретным
сигнал: сигналах
работа: работает работать
узна: узнаем узнать
как: какие какого каких
разъ: разъ
применим: применимы
интернет: интернет интернета интернете
кор: коров
беспроводн: беспроводные
технолог: технологии технологий
прототипирован: прототипирование
песочниц: песочницы публикации
больш: большому большое
счет: счету
хоч: хочу
поведова: поведовать
небольш: небольшом небольшой
проект: проекте проектах нативные
нача: начать начало
хотел: хотелось заметке
издалек: издалека
вер: верить
основател: основателю
псиохоанализ: псиохоанализа
мног: многие
проблем: проблемы проблеме
род: родом сравнению
детств: детства
свободн: свободное
школ: школы
ма: мая
ляжет: ляжет
снег: снег
приход: приходилось
стереч: стеречь
гол: голов
крупнорогат: крупнорогатого
скот: скота
крс: крс
исход: исходя
вышесказа: вышесказанного
иде: идея
избав: избавиться
интересн: интереснейшего
занят: занятия
облегч: облегчить
труд: труд
покида: покидает
голов: голову
се: сей
будуч: будучи
студент: студентом количества
равн: равно
занима: заниматься занимаемся занимаюсь
собра: собрал
подручн: подручных
средств: средств
катушк: катушки
зажиган: зажигания
радиодетал: радиодеталей
стар: старого машиной вернуться
телевизор: телевизора
электропастух: электропастуха
хайп: хайп
нейросет: нейросетями нейросеть нейросети нейросетью
тв: тв
сво: сво
чуж: чужие
обработк: обработка обработки обработку
изображен: изображений изображения
графическ: графический
искусствен: искусственный
интеллект: интеллект
мнен: мнение
профильн: профильных
новостн: новостных
телеграмм: телеграмм
канал: каналов
крупн: крупные крупных
сми: сми
опубликова: опубликовали
прогноз: прогноз
погод: погоды погода
ставропол: ставрополья
созда: созданный созданные созданную создаем создающая создать создается создаются
истор: истории
личн: личный личного лично
кабинет: кабинет кабинета
част: часть части глаза
анализ: анализ анализом
конкурент: конкурентов
веб: веб
сайт: сайтов сайту сайте сайты устройство
тестирован: тестирование тестирования
сервис: сервисов
аналитик: аналитика
русск: русский
свет: свет
форм: форма
регистрац: регистрации войти
возможн: возможности возможность виндузятнику
введ: введ
нног: нного
парол: пароля
отсутств: отсутствие
введен: введенного введенные
привест: привести
ошибк: ошибкам
набор: наборе
повторн: повторному повторное повторный
ввод: вводу ввод
вызва: вызвать
раздражен: раздражение
затрат: затраты
кнопк: кнопка
повтор: повтора
заказ: заказа заказ
упроща: упрощает
процесс: процесс процесса познакомим
оформлен: оформления оформлении оформлением
пользовател: пользователя пользователей дурак
поскольк: поскольку
дан: данные данных данной
автоматическ: автоматически
заполн: заполнены
так: таким
образ: образом образ
трат: тратить
помога: помогает
ускор: ускорить
сторон: стороны сторона
связа: связано
содерж: содержит
необходим: необходимые необходимость необходимости
тестиру: тестируем
анализиру: анализируем
всяк: всяким
кейс: кейс
собствен: собственно собственные собственными
говор: говоря
присутств: присутствуют
чек: чек
лист: листы
постара: постараемся
подойт: подойти
комплексн: комплексно
посмотр: посмотрим
получ: получится получившийся
сраз: сразу
долг: долгих
подготовок: подготовок
определ: определимся
нужон: нужон
сам: самый самое самые
сокращен: сокращенно
лк: лк
организац: организация
либ: либо
настро: настроен настроить
офлайн: офлайне
оптимизац: оптимизации
ресурс: ресурсов
автоматизац: автоматизации
рутин: рутины
перевел: перевела
онлайн: онлайн
клиент: клиента клиент клиенты
реша: решает
важн: важных важнейший
задач: задачи задача
фотореализм: фотореализм
обзор: обзор
бесплатн: бесплатных бесплатно
генерац: генераций генерации
пришл: пришлось
иска: искать
альтернатив: альтернативы
покор: покорила
сотн: сотни
мир: миру мир
качеств: качеством качества
картинок: картинок
пута: путают
реальн: реальными реальном
рисунк: рисунками
фотограф: фотографиями
нашл: нашлись
недостатк: недостатки
редк: редко
польз: пользуюсь
повседневн: повседневной
жизн: жизни
стоимост: стоимость
попыток: попыток
сто: стоят стоит
подписк: подписка
писа: писать писали писал
запрос: запросы запросов запросам
английск: английском
попробова: попробовать
запуст: запустить запусти
взят: взять
умеет: умеет
преимуществ: преимуществом
бот: боте
явля: является
запуск: запуска
потреб: потребуется
минимум: минимум
гб: гб
видеопамят: видеопамяти
ещ: ещ
вс: вс
общ: общем искажение
дают: дают
воспользова: воспользоваться
крут: круто
генерирова: генерировать
мессенджер: мессенджер
рук: рукой
стал: стало стала
одн: одним боли
плюс: плюсом
указыва: указывают
обуча: обучалась индии
баз: базе базу
архитектур: архитектуры дистрибутив
сравнив: сравнивая
модел: моделями модели моделей модель
убед: убедился
синтаксис: синтаксис
намн: намного
прощ: проще
грех: грехов
учитыв: учитывая
минус: минусы
реш: решил
друг: другую
российск: российских
разработчик: разработчиков разработчиком разработчикам
перв: первое первой
интересова: интересовало
смог: смогу
получа: получать
реалистичн: реалистичные
картинк: картинки
хуж: хуже
обраща: обращал
вниман: внимание
скорост: скорость
тариф: тарифов
удобств: удобство
использован: использования
покаж: покажу
пример: примеры примером практичным
уда: удалось
сгенерирова: сгенерировать
озвуч: озвучу
вывод: выводы
посмотрет: посмотреть
разрабатыва: разрабатывали
игр: игр игры игру игра игре играх
игров: игровые игровую
консол: консоли
ретроспектив: ретроспектива
хот: хотите хотят
дарк: дарк
соулс: соулса
стратег: стратегий стратегию
добр: добро
пожалова: пожаловать
старкрафт: старкрафт
вспомн: вспомним вспомнить
культов: культовую
корпорац: корпорацией корпораций
конц: конце
х: х
эталон: эталоном
дела: делали делать
хорош: хорошие серии
провалива: проваливались
настольк: настолько
популярн: популярной настройка любой
официальн: официальной официальную официальный
религ: религией
национальн: национальным
кибер: кибер
спорт: спортом
азиатск: азиатской
стран: страны разных
бородат: бородатые
легенд: легенды
глас: гласят
отц: отцы
государств: государства
дочер: дочерей
жених: женихов
способн: способных
обыгра: обыграть
мультиплеер: мультиплеере
запа: запала
сердечк: сердечко
любител: любителям
годн: годных
просчитыва: просчитывать
шаг: шаг
шахмат: шахматах
игра: играть
приятн: приятно
правильн: правильно
подсчита: подсчитал
стукнул: стукнуло
слов: словом слова
праздник: праздник
мар: мар
создан: создание создания создании
высокодетальн: высокодетальных
технологическ: технологического технологическое
оборудован: оборудования
реверс: реверс
инжиниринг: инжиниринг
привет: привет
зовут: зовут
марат: марат
расскаж: расскажу расскажем
огромн: огромную
промышлен: промышленных промышленного
предприят: предприятий предприятия
инструмент: инструменты
использу: используем
итак: итак
разработа: разработать
мал: малого
детальн: детальных
функционир: функционирующего
состав: составе
действ: действующего
нефтехимическ: нефтехимического
комплекс: комплекса
дальн: дальнейшем
цифров: цифровые
использова: использоваться использовано возможно
наш: нашей
систем: системе сборка архитектура
эксплуатацион: эксплуатационной
информацион: информационной
выбра: выбрали
легк: легкий локациями
пут: путь пути путем
дневник: дневник дневниках
настольн: настольный настольной
мотив: мотивам
танчик: танчиков
арх: архив
рабоч: рабочих рабочий
прототип: прототипов прототип
продвижен: продвижение
образова: образовался
некотор: некоторый изменены
перер: перерыв
основн: основную основные основной устройствами
ход: ходе выявились
описа: описали
подготовк: подготовкой
верстк: версткой
макет: макетов макеты
компонент: компонентов компоненты компонентами
правил: правилами
сдан: сданы
печа: печать
разобра: разобрать разобраться
накоп: накопившиеся
архив: архивы
показа: показать
рассказа: рассказать
рол: роли
кажд: каждой
итерац: итерации
изготовлен: изготовленные
вручн: вручную
сыгра: сыграть
поня: понять
механик: механику
пользова: пользоваться
точк: точки
зрен: зрения
эргономик: эргономики
дает: дает
выглядет: выглядеть
печат: печати печатью
черн: черно
бел: белом
лазерн: лазерном
принтер: принтере
полноцен: полноценной
цветн: цветной
меня: менялся
пиксельн: пиксельный
стил: стиль
примитивн: примитивного
битн: битного битным
финальн: финального
условн: условно условная условного
назва: назвать
геодезическ: геодезической
сфер: сфере
алгоритм: алгоритмы
процедурн: процедурной
изуч: изучим
уютн: уютным
любим: любимых
оскар: оскаром оскара
сталберг: сталбергом
скриншот: скриншоты
наполовин: наполовину
дем: демо
итог: итоге
настоя: настоящую
маг: магию
счаст: счастью
подробн: подробности
пост: постов
темн: темная
исследован: исследований исследования
когнитивн: когнитивные некий
искажен: искажения когнитивное
порт: портят
результат: результаты
интр: интро
разрез: разрезе
влиян: влияния
исследовател: исследователя исследователям
полезн: полезна
джун: джунам
мидл: мидлам
заказчик: заказчикам
понима: понимать понимаете
опасн: опасности
подстерега: подстерегают
увлекательн: увлекательном
путешеств: путешествии
назван: названием
естествен: естественно
сорр: сорри
тем: темы
знаком: знакомы
проход: проходят
поверхностн: поверхностный
фильтр: фильтр
адекватн: адекватности
встреча: встречается
привлека: привлекает
заставля: заставляет
прочита: прочитать
полност: полностью
заметк: заметки написать
реж: реже
появля: появляются
прям: прямо прям
хочет: хочется
прокомментирова: прокомментировать
перевест: перевести
отличн: отличная
платн: платная платном
котор: которую которым
захотел: захотелось
дополн: дополнить
лонгрид: лонгрид
охват: охватить
чашечк: чашечкой
коф: кофе
рекоменд: рекомендую
запоминан: запоминания
возвраща: возвращаться
материал: материалу
возника: возникает
потребн: потребность
способ: способ
самоопределен: самоопределения
сред: среди
страх: страх
дизайнер: дизайнеров
люб: любого подойд научитесь
творческ: творческого
человек: человека
объект: объект движения
предмет: предмет
искусств: искусства искусством
помощ: помощью
вовс: вовсе
создава: создавать
пользовательск: пользовательские пользовательское пользовательского пользовательских пользовательский
представлен: представления представление бизнес
мобильн: мобильных
приложен: приложений приложения
кастомн: кастомные
андроид: андроид
устройств: устройств мультимедиа информация
предлага: предлагаю критикуем
документац: документацию
язык: язык дзен
котлин: котлин
перейт: перейти
вопрос: вопросах главное
элемент: элемент элементы
использ: используются
существ: существующие
предоставля: предоставляемые предоставляет предоставляют
соответств: соответствуют
требован: требованиям
функциональн: функциональности совмещают
расширен: расширения
класс: класса
базов: базовую
структур: структуру
рисован: рисования
взаимодейств: взаимодействий
услов: условиях
понадоб: понадобится
навык: навык
инновацион: инновационные
уникальн: уникальные
визуальн: визуальные
улучша: улучшают
оп: опыт
обеспечив: обеспечивая
гибкост: гибкость
кастомизац: кастомизацию
ирин: ирина ирине ирину ирины
голосов: голосовой голосовые голосового голосовыми голосовым
помощник: помощник помощника помощником
вкус: вкусом
умн: умный умными умным
дом: дом
лам: лама
альпак: альпака
чатгпт: чатгпт
раздава: раздавалась раздавались
уютненьк: уютненьком
чатик: чатике
множ: множились
гриб: грибы
коммент: комментах
возглас: возгласы
дух: духе
дайт: дайте
болта: болтать
честн: честно
фанат: фанат
общен: общения
виртуальн: виртуальным
долж: должен
выполня: выполнять
команд: команды
каза: казалось
заинтересова: заинтересовало
наскольк: насколько
весел: весело
код: коде
доступ: доступе
утр: утром
снабд: снабдили
ключик: ключиком
продолжен: продолжение
завися: зависящего
печеньк: печеньки
оффлайн: оффлайн
поддержк: поддержка
плагин: плагинов плагин
готов: готовые
таймер: таймер
ряд: ряд
проч: прочих
серверн: серверном
режим: режиме
сервер: сервер
куч: куча
микрофон: микрофонов
телегр: телеграм
например: например
улучш: улучшилось
прошедш: прошедший
момент: момента
прошл: прошлой
добавл: добавлен добавлено
пакет: пакет популярного
упрощен: упрощенной
установк: установки
скача: скачай
распозна: распознает
браузер: браузере
тяжел: тяжелый
отправля: отправляет
звуков: звуковой
запуска: запускать
смартфон: смартфоне
имх: имхо
озвучиван: озвучивание
доступн: доступное
открыт: открытом
докер: докер
быстр: быстрого
зависим: зависимостей
нечетк: нечеткое
распознаван: распознавание распознавания
фраз: фраз фразу
обновл: обновлена
специальн: специально
натренирова: натренированную
колонк: колонками колонкам
ассистент: ассистентами ассистентам
машин: машинное машины демонической
обучен: обучение
слыша: слышали
дьявол: дьявол
детал: деталях
лад: лада
грант: гранта гранты
мерседес: мерседеса мерседесов
отлича: отличается
фактическ: фактически
об: обе
езд: ездят
воз: возят
пассажир: пассажиров
главн: главная нафига
функц: функция
мелоч: мелочам
продума: продуманный
разительн: разительно
влия: влияют
восприят: восприятие
продукт: продукта опыта
попробу: попробуем
угол: угол
попыта: попытаемся месте
хвата: хватает
исправ: ним
сборк: исправить система
настройк: сборки
мультимед: пакета
камер: основном
появ: камерами
рассмотр: появилась
осуществ: рассмотрим
собира: осуществить
подойд: собирать
современ: популярный
дистрибут: современный
критику: системы
инфраструктур: предлагаем
стандарт: инфраструктура
бизнес: стандарты
измен: представлении
структурн: некоторые
особен: структурные
атомарн: особенности картины
выдержива: атомарная
смыслов: выдерживает
терминологическ: смысловой
критик: терминологической
атом: критики
молекул: атомы
метафор: молекулы материи
частиц: метафора
матер: частиц
физик: метафоры
хим: физики
идут: химии
страниц: идут
шаблон: страницы
внос: шаблоны
нек: вносит
картин: общую
имеет: дизайна
архитектурн: имеет
упущен: архитектурных
выяв: упущений
опыт: ходу
треб: продуктах
проработа: требуют
карт: проработанной
пошагов: потоков
руководств: пошаговое текущем следуя
мощн: руководство
движен: мощный
различн: объектов
географическ: различными
локац: географическими
реализ: легко
сут: реализуется
совмеща: сути
потоков: функциональность
диаграмм: потоковой
тип: диаграммы
визуализац: тип
направлен: показывает
товар: направление
денег: товаров
информац: денег песочница
текущ: информации
познаком: руководстве
практичн: сделать
инд: студентов
разн: обучающихся
следу: странах
науч: руководству
вид: любых
сравнен: видов
сер: родилась
сойт: хороших
ум: сойти
причин: ума
переход: причин
справ: переходить
демоническ: справиться
дурак: старый
стаж: пользователь
куп: стажа
макбук: купить
предпоследн: макбук
стильн: предпоследний
модн: стильный
молодежн: модный
процессор: молодежный
нафиг: процессоре
риторическ: вопрос
предполага: риторический
ответ: предполагающий
заскорузл: ответа
виндузятник: заскорузлому
чуд: использовать
яблок: чудо
сильн: яблоком
бол: сильной
мест: одном
написа: попытаюсь
полгод: хотел
глаз: полгода
эпилог: частей
сюд: эпилогом
аккаунт: сюда
войт: аккаунт
раздел: регистрация
публикац: разделы
документ: компаний
соглашен: документы
конфиденциальн: соглашение
услуг: конфиденциальность
корпоративн: услуги
медийн: корпоративный
реклам: медийная
нативн: реклама
образовательн: проекты
программ: образовательные
стартап: программы
мегапроект: стартапам
яндекс: мегапроекты
дзен: яндекс
техническ: языка
вернут: техническая
верс: старую
rss: rss
dovgaluk: dovgaluk
assembl: assembler assembly
d: d
manw: manwe
sand: sands
frog: frog
demo: demo
parti: party
bright: bright
translat: translate
pcie: pcie
ruvd: ruvds
dii: diy
prochii: prochiy
arduino: arduino
getrend: getrender
mazkonik: mazkonik
usabl: usability
http: https
rs: rs
ru: ru
custom: customer custom
person: person
regist: register
mochila: mochila
midjournei: midjourney
data: data
engin: engineering
discord: discord
automat: automatic
dreambooth: dreambooth
civitai: civitai
huggingfac: huggingface
telegram: telegram
stabl: stable
diffus: diffusion
turbotext: turbotext
mj: mj
shyhartskoi: shyhartskoi
starcraft: starcraft
timeweb: timeweb
cloud: cloud
blizzard: blizzard
rt: rts
ggmm: ggmm
bimeist: bimeister
cad: cad
cam: cam
pradd: pradd
dendi: dendy
patientzero: patientzero
planet: planet
twitter: twitter
lightmak: lightmaker
ux: ux
dark: dark
side: side
user: user
research: research
cognit: cognitive
bias: biases
taint: taint
result: results
lizapri: lizapris
ro: ro
dev: dev
android: android
view: views view
kotlin: kotlin
janvarev: janvarev
gpt: gpt
open: open
sourc: source
python: python
api: api
speechtotext: speechtotext
texttospeech: texttospeech
homeassist: homeassistant
tl: tl
dr: dr
window: windows
tt: tts
silero: silero
vosk: vosk
bugman: bugman
dungeonlord: dungeonlords
l: l
util: utils
meson: meson
linux: linux
ubuntu: ubuntu
sablim: sablime
javascript: javascript
css: css
html: html
js: js
klvov: klvov
maco: macos
nix: nix
mac: mac
m: m
pro: pro
facebook: facebook
vk: vk
youtub: youtube
habr: habr
