хабр: хабр хабре хабра
откр: открыть
список: список
стат: стать статье статьи
автор: автором авторы авторов
поток: потоки
разработк: разработка разработку разработки разработке
администрирован: администрирование
дизайн: дизайн
менеджмент: менеджмент
маркетинг: маркетинг
научпоп: научпоп
поиск: поиск
профил: профиль
обнов: обновить
оценк: оценка
компан: компании компаниями компания компаний
карьер: карьере
рейтинг: рейтинг
инфраструктур: инфраструктура инфраструктуру инфраструктуры
бизнес: бизнеса бизнесу
блог: блог
новост: новости
ваканс: вакансии
подписчик: подписчики
ещ: ещ
сотрудник: сотрудники
нов: новые новой
скопирова: скопировать
ссылк: ссылку
показыва: показывать
лучш: лучшие лучших
примен: применить
час: часов
портативн: портативные
консол: консоли
весн: весны весной
модел: моделей модели моделями
сто: стоит стоить
обрат: обратить
вниман: внимание вниманием
прочтен: прочтение
мин: мин мини
количеств: количество
просмотр: просмотров
гаджет: гаджеты гаджетов
компьютерн: компьютерное
желез: железо
игр: игры
игров: игровые
выходн: выходные
отдыха: отдыхать
вид: видов
отдых: отдыха
видеоигр: видеоигры видеоиграх
устройств: устройств устройство
созда: создано создать
включ: включая
известн: известных известно
девайс: девайсов девайсах девайс девайсы
именит: именитые
создава: создаваемые
небольш: небольшими небольшой
либ: либо
организац: организациями организации
врод: вроде
специализир: специализируются
сред: среди
многообраз: многообразия
весьм: весьма
удачн: удачные
позволя: позволяют позволяет
игра: играть
дорог: дороге
дом: дома
тв: тв
клавиатур: клавиатур
контроллер: контроллеров
так: таких такого такими таким
пойдет: пойдет
реч: речь
чита: читать
добав: добавить
закладк: закладки
комментар: комментарии комментариях
упрост: упростить
анализ: анализ анализом
дан: данных данные данными
запуск: запуск
сценар: сценарии
использован: использования
готов: готовой готовое
виртуальн: виртуальной
машин: машины машинное машинному машинного машинном
аналитик: аналитики аналитиком аналитику
уровен: уровень
сложност: сложности
прост: простой простого простыми
обучен: обучение обучению обучения обучении
поход: походы
вещ: вещь вещи
непредсказуем: непредсказуемая
полезн: полезная полезные полезными полезных
нагрузк: нагрузка
распределя: распределяется
участник: участниками
вмешива: вмешивается
элемент: элемент
случайн: случайности
забывчив: забывчивости
ситуац: ситуациях ситуации ситуация
выруча: выручает
швейцарск: швейцарский
нож: нож ножа
гарантир: гарантирует
минимальн: минимальные
потребн: потребности
групп: группы
удовлетвор: удовлетворены
помощ: помощью помощи
консерв: консервы
бинт: бинт
разреза: разрезать
главн: главное
эконом: экономит экономить
мест: место
рюкзак: рюкзаке
команд: команде
работа: работает работать работаю
хочет: хочется
решен: решение решения
базов: базовых
задач: задач задачу задачи
собира: собирать
самостоятельн: самостоятельно
отдельн: отдельных
компонент: компонентов
удобн: удобно удобное
дор: дорого
существова: существовало
как: какое какие каких
компактн: компактное
котор: котором
сраз: сразу
набор: набор
инструмент: инструментов инструменты инструментом
настроек: настроек
усажива: усаживайтесь
костр: костра
поудобн: поудобнее
пришл: пришло
рассказа: рассказать
голос: голосов
мар: мар
тройн: тройные тройное
зарплат: зарплаты
инженер: инженеров инженер инженером инженеру
национальн: национальный национального
инструментар: инструментарий инструментария
кита: китай китаю
реша: решает решается решаем решать
пробл: проблему
производств: производства производство производстве производством производству
чип: чипов чипы
исследован: исследования
прогноз: прогнозы
электроник: электроники
тем: тема
кит: китая
затрагива: затрагивалась
кнр: кнр
пыта: пытается пытаемся
реш: решить решил
санкц: санкций санкции санкциями санкциях
развернут: развернуть
собствен: собственную собственные собственный собственного
современ: современных
электрон: электронных электронную
сист: систем
работ: работа работы работу работе
ведет: ведется
перемен: переменным
успех: успехом
наскольк: насколько
суд: судить
вопрос: вопрос вопросами
понемног: понемногу
быстр: быстро быстрее
хотел: хотелось
правительств: правительству
стран: страны
ускорен: ускорения
процесс: процесса процесс
импортозамещен: импортозамещения импортозамещение
фактор: фактора
проектирован: проектирования
охот: охоту
голов: головами
подробн: подробности подробнее
кат: катом кат
скача: скачал
плагин: плагин плагины
опингвин: опингвинился
программирован: программирование
обзор: обзор
эффективн: эффективность эффективному эффективнее
завис: зависит
скилл: скиллов
программист: программиста
рабоч: рабочего рабочей
окружен: окружения окружение
оптимизирова: оптимизировать
использова: использовать использоваться
специальн: специальные
расширен: расширения
текст: тексте текстов тексты
собра: собрали
сам: самые самый
мнен: мнению мнение
специалист: специалистов
сохраня: сохраняйте
подборк: подборку
дел: делитесь делюсь
сво: своими своему
вариант: вариантами варианты
способ: способы способами способ
баз: базами баз базой
сложн: сложному сложной сложно сложных сложный сложнее
сетев: сетевые
технолог: технологии технологиям технологий
диаграмм: диаграммами
архитектур: архитектур архитектуры
скрыва: скрываются
витиеват: витиеватые
ярк: яркий
пример: пример
связ: связь
веб: веб
сервер: сервером сервер серверов серверами серверу серверах
отлича: отличаются
преимуществ: преимущества
недостатк: недостатки
приход: приходят
клиент: клиенты клиентам
поэт: поэтому
постара: постарались
расстав: расставить
полочк: полочкам
показа: показать
связа: связать связаны связана
соединен: соединение
весен: весенние
пк: пк
предлага: предлагают предлагаю
производител: производители производителей производителя
март: марте марта
офис: офиса
настольн: настольные
компьютер: компьютеры
миниатюрн: миниатюрные
нрав: нравятся
мног: многим многих
достоинств: достоинств
бесшумн: бесшумность
мал: малый
шум: шума
активн: активным
охлажден: охлаждением
плюс: плюс
возможн: возможность возможности возможно
убра: убрать
глаз: глаз
дол: долой
подвес: подвесив
задн: задней
крышк: крышке
монитор: монитора
представ: представили представила
интересн: интересных интересного интересно интересные
производительн: производительные производительности
качеств: качестве
лошадк: лошадки
модульн: модульность модульных модульный
больш: большой большую
букв: буквы
характеристик: характеристики характеристиках
дюймов: дюймового
ноутбук: ноутбука ноутбуки ноутбуков ноутбук
ко: кое
настоя: настоящему
мод: мода
вероятн: вероятно
нача: началась начало начались
гугловск: гугловского
проект: проекта проект проекты проектов
смартфон: смартфона смартфонов
иде: идея
отличн: отличной
модул: модули модулей
креп: крепятся
магнит: магнитов
зам: замена замены
должн: должна
занима: занимать
пар: пару пара
секунд: секунд
дольш: дольше
люб: любом
случа: случае
обычн: обычных
разбира: разбираемых
отверток: отверток
пинцет: пинцетов
добр: доброго добро
слов: слова
мастер: мастера
владельц: владельца
сожален: сожалению
получ: получила
коммерческ: коммерческого
воплощен: воплощения
закр: закрыли
оста: осталась
стал: стали стало
реализовыва: реализовывать
некотор: некоторые некоторых
закрыва: закрывались
добира: добирались
отгрузок: отгрузок
одн: одним
писа: писали писал
скор: скором
появ: появятся
продаж: продаже
китайск: китайское китайские китайского китайских
интерфейс: интерфейс интерфейса
чиплет: чиплетов
процессор: процессоров процессоры процессорами
поскольк: поскольку
постепен: постепенно
перекрыва: перекрывают
воздух: воздух
доступ: доступ доступа
международн: международным
понятн: понятно
стара: старается стараются
выйт: выйти
положен: положения
получа: получается получают
например: например
заяв: заявили
дает: дает
уйт: уйти
американск: американских
разработа: разработать разработали
дела: делают делается
китайц: китайцы
коленк: коленке
нейросет: нейросеть
облак: облаке
минут: минут
искусствен: искусственный искусственного
интеллект: интеллект
будущ: будущее
туториа: туториал
постро: построить
конвейерн: конвейерную
лент: ленту
нейронок: нейронок
нуж: нужен
настроен: настроенное
библиотек: библиотекой
генерирова: генерировать
вайф: вайф
режим: режиме
пожалова: пожаловать
взаимодейств: взаимодействию взаимодействие взаимодействуют
микросервис: микросервисов микросервисы
трем: тремя
кейс: кейс кейсов
заход: заходит
вспомина: вспоминают
архитектурн: архитектурных
паттерн: паттернах
расскаж: расскажу
выполн: выполнить
простеньк: простенькую
задачк: задачку
наворочен: навороченной
мо: моем
создан: создание
сервис: сервиса сервисов сервисы
агрегир: агрегирует
событ: события событий
един: единую
останов: остановитесь
замедля: замедляет
экспорт: экспорта
экспортн: экспортных экспортной
торгов: торговых торговые
ограничен: ограничениях ограничения ограничений
применя: применяет
сша: сша
отношен: отношении
поднебесн: поднебесной
неоднократн: неоднократно
сильн: сильно
меша: мешают
развива: развивать развиваю
промышлен: промышленность
част: часть
партнер: партнеры
науч: научились научилась
обход: обходить
идет: идет
поставк: поставках
графическ: графических
ускорител: ускорителей
сторон: стороны
каза: казалось
соблюда: соблюдать
прав: правила
торговл: торговли
аналогичн: аналогичным
образ: образом
поступа: поступают
попа: попали
сил: силами
избежа: избежать
материал: материалы материалами материалов материале
помогут: помогут
пройт: пройти
сквоз: сквозь
джунгл: джунгли
термин: терминов
математик: математика математики
привет: привет
зовут: зовут
еф: ефим
прошл: прошлом
автоматизатор: автоматизатором
дат: дата
пада: падаю
пропаст: пропасть
буквальн: буквально
необъятн: необъятная
сфер: сфера
ориентир: ориентиров
основн: основная
проблем: проблема проблемы
раздел: разделов раздел разделы
взгляд: взгляд
нужн: нужны
найт: найти
заполн: заполнить
теоретическ: теоретические
практическ: практические практически
основательн: основательно
подойт: подойти
профессиональн: профессиональному
развит: развитию
занимательн: занимательных
сдела: сделай
привлека: привлекает
разрабатыв: разрабатывая
пуска: пускай
особ: особо
практичн: практичный
любител: любители
удовольств: удовольствие
выполня: выполнять
впоследств: впоследствии
актуальн: актуальные
вовс: вовсе
двойн: двойное
разн: разных
пригод: пригодиться
читател: читателям
ид: идею
оцен: оценить
немецк: немецкая
библ: библия
уда: удалось
откопа: откопать
испанск: испанской
барахолк: барахолке барахолку
истор: история
стар: старое старую
погод: погода
валенс: валенсии
установ: установилась
хорош: хорошая
надолг: надолго
воскресен: воскресенье
отправ: отправился
любим: любимую
несмотр: несмотря
быва: бываю
попада: попадаются
подума: подумал
встрет: встретиться
блошин: блошином
рынк: рынке
исключен: исключение
понрав: понравиться
конц: конце
традицион: традиционный
штук: штука
вмест: вместе
угада: угадать
предназначен: предназначение
приспособлен: приспособлений
поеха: поехали
продолжа: продолжает
мощн: мощными мощные мощнейшими
текущ: текущие
перспектив: перспективы
наход: находится находить
нм: нм
отказа: отказали
производ: производить
оказа: оказалось
негд: негде
план: планах плане
восстанов: восстановить
частност: частности
ясн: ясно
альф: альфа
тестирован: тестирование
рисова: рисовать
рук: руки руками
неонов: неоновых
котик: котиков
инструкц: инструкцию
четверт: четвертую
верс: версию версии
алгоритм: алгоритма
спуст: спустя
месяц: месяца месяц
предлож: предложили
пят: пятой
реалистичн: реалистичность
тонк: тонкую
настройк: настройку настройка
откладыва: откладывать
дава: давайте
взглян: взглянем
дайджест: дайджест
информативн: информативные
непрост: непросто
стоя: стоящий
контент: контент
стас: стас
продукт: продукты
коллег: коллегами коллегам
годн: годные
виде: видео
минимум: минимум
развлекут: развлекут
свеж: свежий
грамотн: грамотно
составлен: составленный
репозитор: репозиториев
сайентист: сайентистов
могл: могли
пропуст: пропустить
английск: английском
язык: языке языка
рунет: рунете
конфигуратор: конфигуратор
капот: капотом
облачн: облачные
похож: похожа похоже
сборк: сборку сборки
мебел: мебели
молотк: молотком
гайк: гайки
закрут: закрутить
реж: реже
останавлива: останавливать останавливается
добавля: добавлять
автоматизац: автоматизацию
ответ: ответ
запрос: запрос
разворачива: разворачивать
взаимодействова: взаимодействовать
пользовател: пользователю
облада: обладать
техническ: технической техническая
экспертиз: экспертизой
подключен: подключения
ключ: ключ
разбер: разберем
состо: состоит
платформ: платформа
посмотр: посмотрим
открыва: открывает
круг: круг
гроз: грозит
инициатив: инициативы
блокирован: блокированию
слаб: слабое
литографическ: литографическое
оборудован: оборудование оборудованием
причин: причине
недоступн: недоступно
большинств: большинства
инач: иначе
незавидн: незавидная
штат: штаты
накладыва: накладывают
лидер: лидеров
отрасл: отрасли
ран: ранее
ужесточа: ужесточают
бот: бот бота
сократ: сократить
диагностик: диагностику
диск: дисков
накопител: накопители накопителей
дмитр: дмитрий
старш: старший
системн: системный
центр: центре
клиентск: клиентским клиентских
обрабатыва: обрабатываю
десятк: десятки
обращен: обращений
физическ: физическим
участ: участием
ног: ногами
пойт: пойти
замен: заменить замену
комплект: комплектующие
робот: роботу
поруч: поручить
нашел: нашел
способн: способного
диагностирова: диагностировать
состоян: состояние
снижа: снижает
влиян: влияние
человеческ: человеческого
высок: высокой
скорост: скоростью
детал: деталям
написа: написал
запуст: запустил
автоматизирова: автоматизировал
выделен: выделенных
сюд: сюда
информац: информация
сайт: сайт сайта
регистрац: регистрации регистрация
основан: основания
сентябр: сентября
числен: численность
местоположен: местоположение
росс: россия
представител: представитель
улья: ульяна
малышев: малышева
аккаунт: аккаунт
войт: войти
публикац: публикации
хаб: хабы
песочниц: песочница
документ: документы
соглашен: соглашение
конфиденциальн: конфиденциальность
услуг: услуги
корпоративн: корпоративный
медийн: медийная
реклам: реклама
нативн: нативные
образовательн: образовательные
программ: программы
стартап: стартапам
мегапроект: мегапроекты
яндекс: яндекс
дзен: дзен
поддержк: поддержка
вернут: вернуться
selectel: selectel
rss: rss
greiv: greiv
selenzorn: selenzorn
big: big
data: data
engin: engineering
ml: ml
analyt: analytics
virtual: virtual
machin: machine
davm: davm
erbanovanastasia: erbanovanastasia
id: ide
vim: vim
git: git
node: node
js: js
doctor: doctor
uml: uml
er: er
l: l
vpn: vpn
monrev: monreve
framework: framework
ara: ara
mvp: mvp
sagidullin: sagidullin
midjournei: midjourney
diffus: diffusers
gpu: gpu
gardii: gardiys
python: python
event: event
bu: bus
cqr: cqrs
nvidia: nvidia
feanoref: feanoref
scienc: science
mlop: mlops
raspberri: raspberry
pi: pi
dii: diy
droman: droman
nintendo: nintendo
ds: ds
hp: hp
elitedesk: elitedesk
g: g
huawei: huawei
tsmc: tsmc
firemoon: firemoon
s: s
valuev: valuev
chatgpt: chatgpt
googl: google
learn: learning
landscap: landscape
ai: ai
postgresql: postgresql
paa: paas
seleditor: seleditor
smic: smic
dkhamchenko: dkhamchenko
api: api
ru: ru
facebook: facebook
twitter: twitter
vk: vk
telegram: telegram
youtub: youtube
habr: habr
