хабр: хабр
откр: открыть
список: список
стат: стать
автор: автором авторы авторов
поток: потоки
разработк: разработка
администрирован: администрирование администрирования
дизайн: дизайн
менеджмент: менеджмент
маркетинг: маркетинг
научпоп: научпоп
поиск: поиск
профил: профиль
обнов: обновить
оценк: оценка
компан: компании компаниями компанией компания компаний
карьер: карьере
рейтинг: рейтинг
инфраструктур: инфраструктура
бизнес: бизнеса
час: часов
портативн: портативные
консол: консоли консоль консолей
весн: весны
модел: моделей модели
сто: стоит
обрат: обратить
вниман: внимание
прочтен: прочтение
мин: мин
количеств: количество
просмотр: просмотров
блог: блог
гаджет: гаджеты
компьютерн: компьютерное
желез: железо
игр: игры игр
игров: игровые игровая
выходн: выходные
отдыха: отдыхать
лучш: лучших лучшие
вид: видов
отдых: отдыха
видеоигр: видеоигры видеоиграх
устройств: устройств устройство устройства
созда: создано
включ: включая
известн: известных
девайс: девайсов девайсах девайса девайсы девайс
именит: именитые
создава: создаваемые
небольш: небольшими
либ: либо
организац: организациями
врод: вроде
специализир: специализируются
сред: среди
многообраз: многообразия
весьм: весьма
удачн: удачные
позволя: позволяют
игра: играть
дорог: дороге
дом: дома
тв: тв
клавиатур: клавиатур
контроллер: контроллеров
так: таких таким такого
пойдет: пойдет
реч: речь
достаточн: достаточно
продвинут: продвинутая
экран: экраном
дюйм: дюймов
разрешен: разрешением
пиксел: пикселей
внутр: внутри
четырехъядерн: четырехъядерный
процессор: процессор
гб: гб
оперативн: оперативной
памят: памяти
особ: особо
мощн: мощное мощного мощной
проектирова: проектировалось
дел: дело делиться
облачн: облачная облачных
предназнач: предназначена
главн: главное
налич: наличие
интернет: интернета
удобн: удобных
орган: органов органами
управлен: управления
хорош: хорошего
экра: экрана экран
поставля: поставляется
внутрен: внутренней
ос: ос
характеристик: характеристики характеристик
локальн: локально
андроид: андроид андроидом андроида
стар: старые старую
тайтл: тайтлы
предназначен: предназначение
подключа: подключается
облак: облаку
скор: скором
надеют: надеются
сможет: сможет
состав: составить
конкуренц: конкуренцию
пропускн: пропускная
способн: способность
ближайш: ближайшей
сет: сети
нормальн: нормальная нормальной
пробл: проблем
возникнут: возникнуть
подключен: подключения
модул: модуль
батаре: батарея
ма: ма мае
ч: ч
слот: слот
карт: карт
порт: порт порта
аудиовыход: аудиовыход
проект: проект проекты
недел: недель
собира: собирал
средств: средства
собра: собрал
заказчик: заказчики
получат: получат
куп: купить
остальн: остальным
стоимост: стоимость
выш: выше
зависим: зависимости
конфигурац: конфигурации
напомина: напоминает
имеет: имеет
японск: японской
общ: общего
рассчита: рассчитано
ретр: ретро
нижн: нижней
панел: панели панелью
располож: расположены
орга: органы
сенсорн: сенсорный
график: графика
памя: память
охлажден: охлаждение охлаждения
активн: активное активная
мм: мм
ауд: аудио
джек: джек
грамм: граммов
отгрузк: отгрузка
начнет: начнется
апрел: апреля
прич: причем
приоритет: приоритет
оформ: оформил
предзаказ: предзаказ
ран: ранее
слаб: слабое
точк: точки
зрен: зрения
удивительн: удивительно
базир: базируется
микроконтроллер: микроконтроллере микроконтроллер
экспериментальн: экспериментальный
работа: работает
неплох: неплохо
правд: правда
низк: низкая
сдела: сделать
деньг: деньги
покупател: покупатель
получа: получает
дюймов: дюймовым дюймовый
нескольк: несколькими
кстат: кстати
использова: использовать
комплект: комплект
вход: входит
придет: придется
покупа: покупать
отдельн: отдельно
качеств: качестве
дополнительн: дополнительного
аксессуар: аксессуара
выгляд: выглядит
сраз: сразу
плюс: плюс
картридер: картридер
емк: емкая
кастомизируем: кастомизируемая
настраива: настраивать
сво: своему своем
вкус: вкусу
цен: цене
начина: начинается
верс: версию
оз: озу
пластиков: пластиковым
корпус: корпусом
чип: чипом чипов
эмулятор: эмуляторы
мног: многих
назва: назвать
справля: справляется
большинств: большинством большинстве большинство
доступн: доступных
связ: связи
поддержива: поддерживает
систем: система
разработчик: разработчик разработчики
утвержда: утверждает
практическ: практически
слышн: слышно
необходим: необходимые
диспле: дисплеем
неоднократн: неоднократно
выпуска: выпускала
сна: сна
баз: базе
привычн: привычные
геймер: геймерам
возможн: возможно
текст: тексты
заинтерес: заинтересуют
геймифицирова: геймифицировать
аренд: аренду
сервер: серверов
скидк: скидкой
связа: связав
сайт: сайт сайта
эффективн: эффективно
результат: результатами
работ: работы
хвастовств: хвастовстве
здоров: здорового
человек: человека
разработа: разработать
бот: бота
генерац: генерации
сложн: сложных
парол: паролей
сожален: сожалению
неизвестн: неизвестны
фотограф: фотографиям
примерн: примерно
суд: судить
обеща: обещают
достойн: достойный
конкурент: конкурент
тег: теги
хаб: хабы
добав: добавить
закладк: закладки
комментар: комментарии
вконтакт: вконтакте
карм: карма
антон: антон
юзер: юзер
публикац: публикации
сутк: сутки
похож: похожие
информац: информация
дат: дата
регистрац: регистрации регистрация
март: марта
основан: основания
сентябр: сентября
числен: численность
местоположен: местоположение
росс: россия
представител: представитель
улья: ульяна
малышев: малышева
аккаунт: аккаунт
войт: войти
раздел: разделы
новост: новости
песочниц: песочница
документ: документы
соглашен: соглашение
конфиденциальн: конфиденциальность
услуг: услуги
корпоративн: корпоративный
медийн: медийная
реклам: реклама
нативн: нативные
образовательн: образовательные
программ: программы
стартап: стартапам
мегапроект: мегапроекты
яндекс: яндекс
дзен: дзен
настройк: настройка
язык: языка
техническ: техническая
поддержк: поддержка
вернут: вернуться
selectel: selectel
greiv: greiv
abxylut: abxylute
x: x
arm: arm
cortex: cortex
android: a
playstat: android
remot: playstation
plai: remote
steam: play
nvidia: steam
geforc: nvidia
xbox: geforce
game: xbox
pass: game
ultim: pass
wifi: ultimate
bluetooth: wifi
usb: bluetooth
c: usb
kickstart: c
retroid: kickstarter
pocket: retroid
flip: pocket
nintendo: flip
ds: nintendo
spec: ds
px: specs
nit: px
cpu: nits
unisoc: cpu
t: unisoc
core: t
ghz: cores
mali: ghz
g: mali
mc: g
mhz: mc
ram: mhz
gb: ram
lpddr: gb
emmc: lpddr
microsd: emmc
card: microsd
reader: card
fan: reader
port: fan
type: ports
micro: type
hdmi: micro
mm: hdmi
audio: mm
wireless: audio
mah: wireless
watt: mah
speaker: watt
built: speakers
mic: built
os: mic
size: os
weight: size
price: weight
piboi: price
mini: piboy
raspberri: mini
pi: raspberry
kt: pi
r: kt
mediatek: r
helio: mediatek
aya: helio
neo: aya
air: neo
ol: air
window: oled
telegram: windows
logitech: telegram
cloud: logitech
razer: cloud
edg: razer
ru: edge
facebook: ru
twitter: facebook
vk: twitter
youtub: vk
habr: youtube
