хабр: хабр
откр: открыть
список: список
стат: стать статьи
автор: автором авторы авторов
поток: потоки
разработк: разработка
администрирован: администрирование
дизайн: дизайн
менеджмент: менеджмент
маркетинг: маркетинг
научпоп: научпоп
поиск: поиск
профил: профиль
обнов: обновить
предлож: предложить
хаб: хаб хабы
новост: новости
компан: компании компаний
назван: название
сортировк: сортировка
рейтинг: рейтинг
подписчик: подписчики
сюд: сюда
лучш: лучшие
блог: блоги блог
яндекс: яндекс
гк: гк
лан: ланит
аккаунт: аккаунт
войт: войти
регистрац: регистрация
раздел: разделы
публикац: публикации
песочниц: песочница
информац: информация
устройств: устройство
сайт: сайта
документ: документы
соглашен: соглашение
конфиденциальн: конфиденциальность
услуг: услуги
корпоративн: корпоративный
медийн: медийная
реклам: реклама
нативн: нативные
проект: проекты
образовательн: образовательные
программ: программы
стартап: стартапам
мегапроект: мегапроекты
дзен: дзен
настройк: настройка
язык: языка
техническ: техническая
поддержк: поддержка
вернут: вернуться
стар: старую
верс: версию
artifici: artificial
intellig: intelligence
ai: ai
ann: ann
form: forms
intelligenceneur: intelligenceneural
networksaidigestcomput: networksaidigestcomputer
visionmachin: visionmachine
learningdata: learningdata
sciencedata: sciencedata
scienc: science mother
digestimag: digestimage
processingneur: processingneural
paint: paintings
program: programming programs microcontrollers
art: art
creat: creating
comput: computer
machin: machine
learn: learning
basi: basis
neural: neural
networksartifici: networksartificial
intelligencemachin: intelligencemachine
learningimag: learningimage
learningtransform: learningtransformers
popular: popular
python: python
inform: information
secur: security
data: data
protect: protection
bgpqrator: bgpqrator
labscybersecurityvulnerabilitiesposit: labscybersecurityvulnerabilitiespositive
technologiescyberattacksfinancephdaysddo: technologiescyberattacksfinancephdaysddos
attackscryptographi: attackscryptography
interpret: interpreted
high: high
level: level
languag: language
gener: general oriented
purpos: purpose
pythonartifici: pythonartificial
learningcomput: learningcomputer
visiondata: visiondata
digestnatur: digestnatural
manufactur: manufacture
develop: development
electron: electronics
establish: establish
process: a
circuit: process
calculatorop: circuit
ampelectron: calculatorop
designverilogcircuit: ampelectronics
designact: designverilogcircuit
filterfpgasmal: designactive
signal: filterfpgasmall
modellingsmal: signal
transfer: modellingsmall
function: transfer
career: function
work: career
compani: work
industri: companies
mathemat: industry
mother: mathematics
mathc: sciences
angourimathspeci: mathc
relativitylorentz: angourimathspecial
transformationmachin: relativitylorentz
sciencepythondata: transformationmachine
analysissolid: sciencepythondata
model: analysissolid business
read: modeling
room: reading
literatur: room
topic: literature
financ: topics
complex: finance
financi: complex
matter: financial
dii: matters
thumb: diy
calculatordiyarduinoop: thumbs
designcircuit: calculatordiyarduinoop
designjavascriptgitsmart: designcircuit
homeiot: designjavascriptgitsmart
personnel: homeiot
manag: personnel hire
properli: management
hire: properly
part: manage
histori: part
interest: history
stori: interesting
itmo: stories
universityhistori: itmo
health: universityhistory
s: health
live: s
longer: live
research: longer
forecast: research
trend: forecasts
field: trends
universityforecastingbitcoincryptocurrencyresearchreadingacadem: field
papersscientif: universityforecastingbitcoincryptocurrencyresearchreadingacademic
journalsscientif: papersscientific
articlesstatist: journalsscientific
devop: articlesstatistics
softwar: devops
methodolog: software
devopswebrtcwcsmonitoringprometheusgrafanawebsocketmetricstestingans: methodology
c: devopswebrtcwcsmonitoringprometheusgrafanawebsocketmetricstestingansible
imper: c
object: imperative
orient: object
featur: generic
provid: features
facil: providing
memori: facilities
manipul: memory
pv: manipulation
studiostat: pvs
code: studiostatic
analysiscopen: code
sourcestat: analysiscopen
reviewstat: sourcestatic
analyz: reviewstatic
algorithm: analyzer
algorithmsmachin: algorithms
visiongodata: algorithmsmachine
scienceartifici: visiongodata
intelligencedeep: scienceartificial
learningontologyabstract: intelligencedeep
algebra: learningontologyabstract
beginn: algebra
arduino: beginners
dyi: arduino
assembl: dyi
calculatorbldcop: assemble
amproboticsact: calculatorbldcop
filterelectron: amproboticsactive
designservopmsmbrushless: filterelectronics
motor: designservopmsmbrushless
controllercircuit: motor
design: controllercircuit specifically
open: design
sourc: open
studioopen: source
sourcec: studioopen
static: sourcec
analysisstat: static
analysissastbugsc: analysisstatic
pythoncod: analysissastbugsc
review: pythoncode
futur: review
liter: future
knock: literally
door: knocks
hardwar: door
motherboard: hardware
videocard: motherboard
fpgaverilog: videocard
javascript: fpgaverilog
character: javascript
dynam: characterized
weakli: dynamic
type: weakly
prototyp: typed
base: prototype
multi: based
paradigm: multi
javascriptreacttypescriptnod: paradigm
jsnodenodejsfrontendwebpackrest: javascriptreacttypescriptnode
apiwebrtc: jsnodenodejsfrontendwebpackrest
busi: apiwebrtc
entrepreneuri: models
activ: entrepreneurial
bpmnbusinessstartupsmobil: activity
appstaxi: bpmnbusinessstartupsmobile
book: appstaxi
appmobil: booking
developmentquarkuskogito: appmobile
gadget: developmentquarkuskogito
smartphon: gadgets
tablet: smartphones
laptop: tablets
microcontrol: laptops
embeddedcpv: program
studioc: embeddedcpvs
fpgaverilogmicrocontrollerscod: studioc
analysisopen: fpgaverilogmicrocontrollerscode
content: analysisopen
market: content
user: marketing administration
marketingdmitri: users
kabanovitmo: marketingdmitry
scalestartupsmarketingvscextvtechstar: kabanovitmo
infrastructur: scalestartupsmarketingvscextvtechstars
infocent: infrastructure
databas: infocenters
commun: databases networks
system: communication studio
qrator: systems
labsbgpcybersecurityddo: qrator
attackddo: labsbgpcybersecurityddos
attack: attackddos
websit: attacks
make: website
web: making
webrtcwcsjavascriptcdnstreamingrest: web
engin: webrtcwcsjavascriptcdnstreamingrest
devopsiacsreinfrastructur: engineering
managementansibleinfrastructur: devopsiacsreinfrastructure
codeinfrastructur: managementansibleinfrastructure
testinginfrastuctureradiopython: codeinfrastructure
game: testinginfrastuctureradiopython games
consol: game
rock: consoles
paper: rock
scissor: paper
gamedevelopmentgam: scissors
developmentplaystationpv: gamedevelopmentgame
analysispvsgamedevgam: developmentplaystationpvs
enginegam: analysispvsgamedevgame
theorygam: enginegame
java: theorygame
concurr: java
class: concurrent
specif: class
implement: designed
depend: implementation
javapv: dependencies
sourcebig: javapvs
datasastbugspvsstudioc: sourcebig
gamedevpv: datasastbugspvsstudioc
studiogam: gamedevpvs
developmentstat: studiogame
analysisc: developmentstatic
gamedevelopmentgamedesignopen: analysisc
sourcecstat: gamedevelopmentgamedesignopen
analysi: sourcecstatic
instant: analysis
messag: instant
messagingchat: messaging
app: messagingchat
developmentmessengerschatvideo: app
chatchat: developmentmessengerschatvideo
sdkvideo: chatchat
call: sdkvideo
sdkin: calling
messaginginst: sdkin
solutionin: messaginginstant
chat: solutionin
network: chat social
technolog: network
ethernet: technologies
ipv: ethernet
labsnetwork: ipv
securityddo: labsnetwork
attackcryptographystatisticsbgp: securityddos
incidentsddo: attackcryptographystatisticsbgp
attacksopen: incidentsddos
sourcedistribut: attacksopen
social: sourcedistributed
virtual: communities
life: virtual
nix: life
hub: nix
abot: hub
unix: abot
oss: unix
linuxbashdevopsdevelopmentshellembed: oss
linuxcc: linuxbashdevopsdevelopmentshellembedded
rdppv: linuxcc
studio: rdppvs
administr: system
satisfi: user
monitoringwebrtcgrafanaprometheuswcsmetricstestingwebsocketstreamlinux: satisfied
ruvd: monitoringwebrtcgrafanaprometheuswcsmetricstestingwebsocketstreamlinux
selectel: ruvds
timeweb: selectel
cloud: timeweb
otu: cloud
vk: otus
getmatch: vk
firstvd: getmatch
facebook: firstvds
twitter: facebook
telegram: twitter
youtub: telegram
habr: youtube
