хабр: хабр хабре
откр: открыть
список: список
стат: стать статьи статье статья
автор: автором авторы авторов
поток: потоки
разработк: разработка разработке разработкой
администрирован: администрирование
дизайн: дизайн
менеджмент: менеджмент
маркетинг: маркетинг
научпоп: научпоп
поиск: поиск
профил: профиль
обнов: обновить
рейтинг: рейтинг рейтинга
истор: история истории историю
занимательн: занимательные
прошл: прошлого прошлой
компан: компании компаниями компаний компания
подряд: подряд
скопирова: скопировать
ссылк: ссылку
показыва: показывать
нов: новые новая новым нового
лучш: лучшие лучший лучших
порог: порог
уровен: уровень
сложност: сложности
прост: простой
средн: средний
сложн: сложный
примен: применить применим
час: час
проблематик: проблематика
текущ: текущей
концепц: концепции концепцию
миров: мировой
сетев: сетевой сетевого сетевое
инфраструктур: инфраструктуры инфраструктура
решен: решение решения
помощ: помощи помощью
децентрализова: децентрализованного
детерминизм: детерминизма
прочтен: прочтение
мин: мин
количеств: количество количеством
просмотр: просмотров
читальн: читальный
зал: зал
криптовалют: криптовалюты
репортаж: репортаж
привет: привет
уважа: уважаемые
хабровц: хабровцы
пиш: пишу
наболевш: наболевшем
понима: понимаю понимать
информац: информация информации информацию
разрознен: разрозненной
постара: постарался
рассказа: рассказать
основн: основную основным основной основными основном
понят: понятиям
част: часть частой части
понятн: понятна
мастодонт: мастодонтам
област: области областей
ознакомительн: ознакомительна
дума: думаю
интересн: интересна интересные интересное интересному интересно интересного
мног: многим многих
над: надеюсь
весьм: весьма
откладыва: откладывать
вопрос: вопрос
долг: долгий долгу
ящик: ящик
приступ: приступим
приступа: приступать
голос: голосов
добав: добавить
закладк: закладки
комментар: комментарии
новост: новости
апр: апр
шестиядерник: шестиядерник
компьютерн: компьютерное компьютерных
желез: железо
стар: старое старого старую
настольн: настольные
компьютер: компьютеры компьютер компьютеров
процессор: процессоры процессора процессор
обзор: обзор
чита: читать
дал: далее дали
написан: написание
код: кода код
машин: машинного машинное машина
обучен: обучения обучение
вс: вс
измен: изменит изменяя изменил
исследован: исследования
прогноз: прогнозы
искусствен: искусственный
интеллект: интеллект
астролог: астрологи
объяв: объявили
недел: неделю неделе
месяц: месяц
кухон: кухонной
аналитик: аналитики
наста: настало
котор: которую которым котором
писа: писал
удивительн: удивительно
должн: должна
устарет: устареть
устарел: устарела
урок: урок уроками
заключа: заключается
прав: правило
пренебрега: пренебрегают
афоризм: афоризм
описыва: описывает
перв: первую первая первые первых
очеред: очередь
политик: политику
вполн: вполне
неплох: неплохо
технолог: технологиям технологий технологии технологиях технологию
поменя: поменявших поменяли
мир: мир миру мире
сч: сч
быстр: быстрых быстрой быстро
лошад: лошадей
известн: известный известно известная известна известную
инноватор: инноватор
форд: форд
страниц: страница
начина: начинается начинают
реша: решать
задач: задачу
способ: способом способы
пор: порой
полност: полностью
лошадьм: лошадьми
автомобил: автомобилями
так: такого таких
революцион: революционного революционные
нейросет: нейросети
применительн: применительно
программирован: программированию программирование
беспроводн: беспроводные
аудиолампочк: аудиолампочки
ко: кое
неожида: неожиданные
находк: находки
испанск: испанской испанскую
барахолк: барахолки барахолку
блог: блог
автомобильн: автомобильные
гаджет: гаджеты
запоздан: запозданием
рассказыва: рассказываю
сво: своем своему свой
воскресн: воскресном
поход: походе
периодическ: периодически
встреча: встречаю
штук: штуки
айтишн: айтишные
попа: попались
девайс: девайсы
музыкальн: музыкальные
инструмент: инструменты инструментом инструмент
конц: конце
пост: поста
оставля: оставляю
фотограф: фотографии
устройств: устройств устройством устройство
предназначен: предназначение
постав: поставило
тупик: тупик
напомн: напомню
ищ: ищу
гугл: гугле
забан: забанили
хочет: хочется
попробова: попробовать
угада: угадать
поисковик: поисковика
поеха: поехали
династ: династии династий
управлен: управлении управления управление
скор: скорее
страшн: страшно
дайджест: дайджест дайджесте
управля: управляющий
редактор: редактор
отдел: отдела отдел
засел: засел
финальн: финальный
сезон: сезон
сериа: сериала сериал
наследник: наследники
сер: серия серь
натолкнул: натолкнула
мысл: мысль
обросл: обросла
нескольк: несколькими нескольких
факт: фактами фактах
преврат: превратилась превратившемуся
колонк: колонку
заголовк: заголовком
масс: масс массу
мед: медиа
семейн: семейных
получ: получилось получили получил
достаточн: достаточно
кратк: краткое
субъективн: субъективное
авторск: авторское
высказыван: высказывание
захотел: захотелось
собра: собрать собрала
развит: развитием развитие
меня: меняются
бизнес: бизнес
оказа: оказалось
изменен: изменения
происход: происходят
зны: зные
необратим: необратимые
видеоигр: видеоигры видеоигр
иран: иране
стал: стали стала стало
оруд: орудием орудиями
пропаганд: пропаганды пропагандой пропаганду пропаганда
игр: игр
монетизац: монетизация
научн: научно научная
популярн: популярное популярности популярным популярной
современ: современности современных современная
инач: иначе
явля: является
либ: либо
кин: кино
музык: музыка
литератур: литература
социальн: социальные социальных
сет: сети сетях сетей
несут: несут
ин: иного
продукт: продукта
образ: образа
жизн: жизни
как: каких какие
ид: идей идею
естествен: естественно
государствен: государственные
институт: институты
берут: берут
вооружен: вооружение
вышеперечислен: вышеперечисленные
отрасл: отрасли
цел: целях целом
идеолог: идеологии
пропагандистск: пропагандистскими
госмашин: госмашины госмашиной
станов: становились становится
пресс: пресса
рад: радио ради радья
телевиден: телевидение телевидении
мер: мере
увеличен: увеличения увеличению
сред: среди
дошл: дошла
плох: плохо
использ: используют используется
реклам: рекламы реклама
закономерн: закономерность
ост: оста
тся: тся
альтернативн: альтернативных
точек: точек
зрен: зрения
случ: случилось
некогд: некогда
процвета: процветающая
игров: игровая
индустр: индустрия индустрии индустрию
жив: жив живое живые
госпропаганд: госпропаганды
последн: последние
независим: независимые
разработчик: разработчики разработчиков разработчиком
прекрат: прекратили
деятельн: деятельность
оста: остались
связа: связанные
подверга: подвергаются
стко: сткой
цензур: цензуре
мар: мар
перлма: перлман
мат: мать
интернет: интернета интернет
протокол: протокол протокола протоколов
биограф: биографии
гик: гиков
ретроспектив: ретроспектива
изобретател: изобретателей
исследовател: исследователей
большинств: большинство
мужчин: мужчины
женщин: женщины женщин
наравн: наравне
внос: вносили
вклад: вклад вкладе
например: например
ад: ада
лавлейс: лавлейс
написа: написала
программ: программу программы
хед: хеди
ламарр: ламарр
придума: придумавшая
работ: работы
грейс: грейс
хоппер: хоппер
разработа: разработала
компилятор: компилятор
кар: карен
спарк: спарк
продума: продумала
поисков: поисковой
систем: системы система
сто: стоит
знат: знать
существ: существует
хоч: хочу
выдел: выделить
американск: американского американский американски
программист: программиста программистами
инженер: инженера
джо: джой
благодар: благодаря
изобретен: изобретению
связ: связующего
дерев: дерева
усовершенствова: усовершенствованный
друг: другими другим
наработк: наработки
легл: легли
основ: основу основе
передач: передачи
цифров: цифровых
дан: данных данные
математик: математики математика математике
расшифрова: расшифровали
природ: природы
внесл: внесли
биолог: биологию биология биологии
ограничива: ограничивается
рамк: рамками рамках
абстрактн: абстрактных
чисел: чисел
формул: формул
позволя: позволяет
анализирова: анализировать
моделирова: моделировать
сам: самые самых самое самый самым
разнообразн: разнообразные
процесс: процессы процессами процессов
включ: включая включ
биологическ: биологические
дела: делает
невероятн: невероятно
мощн: мощным
наук: науке
детальн: детально
рассмотр: рассмотрим
математическ: математические
метод: методы
применя: применяются применяется
интересует: интересуетесь
жела: желаете
узна: узнать
любопытн: любопытны любопытным
инфернальн: инфернальная
ос: ос
оперед: опередившая
создан: создания
распредел: распредел
нно: нной
подобн: подобной подобную
операцион: операционной
успешн: успешно
реализова: реализовала
проект: проекта проекту проект проектов проекты
дальн: дальнейшее
приостановл: приостановлено
смен: смену
пришл: пришла
платформ: платформа
кодов: кодовым
назван: названием название
опира: опиравшаяся
использова: использовавшая
принцип: принципы
виртуализац: виртуализации
крайн: крайне
дож: дожившему
наш: наших
дне: дней
бесплатн: бесплатную бесплатных бесплатно
свободн: свободной
лиценз: лицензией
посвящ: посвящена
сегодняшн: сегодняшняя
объясн: объяснить
физик: физику физики
и: ии
сгустк: сгустке
шум: шума
капл: капли
черн: чернил
золот: золотой
рыбк: рыбки
перевод: перевод
неограничен: неограниченные
мощност: мощности
виртуальн: виртуальных
дат: дата
центр: центров
распределен: распределенные
возможн: возможность
создава: создавать создавали
ран: ранее ранние
изучен: изученной
позвол: позволило
принима: принимать
эффективн: эффективные
основа: основанные
интуиц: интуиции
созда: создать созданы создал
доступн: доступные доступной
прида: придали
огромн: огромный огромное огромная
импульс: импульс
помогл: помогли
методик: методики
микроэлектроник: микроэлектроники
оптическ: оптических
оптимизац: оптимизации
производствен: производственных
разобра: разобраться
пониман: понимания
физическ: физических
закон: законов
теор: теорий
знан: знание
хард: хард
скилл: скилл
вероятн: вероятно
останет: останетесь
борт: бортом борту
прогресс: прогресса
динамичн: динамично
развива: развивающихся
тезис: тезис
иллюстрир: иллюстрирует иллюстрирующих
подготов: подготовили
маршрутизатор: маршрутизатор
пк: пк
лишн: лишних
детал: деталей
оборудован: оборудование
подойд: подойд
домашн: домашнего
офис: офиса
ответ: ответ
завис: зависит
множеств: множества
фактор: факторов
одн: одних одним
поддержк: поддержка поддержкой
качествен: качественный
корпус: корпус
антен: антенны
энергопотреблен: энергопотребление
выбира: выбирает
жност: жности
отзыв: отзывам
коллег: коллег коллегами
особ: особая
категор: категория
пользовател: пользователей пользователям пользователями
наплева: наплевать
смотр: смотрят смотря
совершен: совершенно
угл: углом
маршрутизац: маршрутизация
программн: программная
функц: функция
железк: железку
угодн: угодно
главн: главное главная
работа: работала работал работает
прошивк: прошивке
ещ: ещ
полноцен: полноценном
линукс: линуксе
удобств: удобства
подума: подумать
обычн: обычный
слегк: слегка
допилен: допиленный
кондиц: кондиции
повлия: повлиял
взросл: взрослых
сообществ: сообщества сообществ
порнограф: порнография порнографии
распространен: распространенных распространения
форм: форм формы
контент: контента контентом
привлек: привлекая
эротическ: эротические
изображен: изображения
врем: времена
античн: античности
эр: эра
массов: массовой
нача: началась начался
век: веке века
появлен: появлением появление
кинематограф: кинематографа
появ: появилась появились появился
х: х
год: годах годов годы
представл: представлены
вид: виде
текстов: текстовых
графическ: графических
файл: файлов
загружа: загружаемых
тогдашн: тогдашние
предшественник: предшественники
онлайн: онлайн
форум: форумов
середин: середине
вмест: вместе
сайт: сайты сайт сайтов сайту сайта
запущ: запущен
начал: начале
скорост: скорости
соединен: соединений
ключев: ключевых
момент: моментов
туб: тубов тубы
предоставля: предоставляли
смотрет: смотреть
виде: видео
загружен: загруженные
привел: привело
резк: резкому
порн: порно
усилен: усилению
давлен: давления
нашл: нашла
заработк: заработка
денег: денег
крупн: крупнейшие крупных
говор: говорить
гигант: гиганту гиганта
исполн: исполнится исполнилось
жит: жить
лет: летит лету
незаметн: незаметно
март: марта
скромн: скромно скромные
небольш: небольшой
переименова: переименованный
никт: никто
знал: знал
существован: существования
релиз: релиз релиза
выпуска: выпускал
пакет: пакеты
кажд: каждого
вперв: впервые
выпуст: выпустил
занима: занимался занималась
встроен: встроенных
сист: систем
шведск: шведских
течен: течение
больш: большим большей
телекоммуникацион: телекоммуникационного
нрав: нравились
устоя: устоявшийся
ежедневн: ежедневный
график: график
втор: вторая
половин: половина
лож: ложилась
спат: спать
продолжа: продолжал
бодрствова: бодрствовать
заним: занимаясь
сут: сути
удава: удавалось
наход: находить
десятк: десятков
сна: сна
ноутбук: ноутбука ноутбуки
дюймов: дюймовым
экран: экраном
предыстор: предыстория
далек: далеком
представ: представила
карма: карманный
совместим: совместимый
представля: представлял
баз: базе
мгц: мгц
оснащен: оснащенное
кб: кб
оз: озу
пзу: пзу
комплектова: комплектовался
монохромн: монохромным
диспле: дисплеем
подсветк: подсветки
разрешен: разрешением
пиксел: пикселей
мерк: меркам
характеристик: характеристики
вышедш: вышедший
имел: имел
битн: битный
частот: частотой
мб: мб
остав: оставил
след: след
будуч: будучи
родоначальник: родоначальником
класс: класса
сверхкомпактн: сверхкомпактный
засвет: засветившись
фильм: фильме фильмов фильм
терминатор: терминатор
судн: судный
джон: джоном
коннор: коннором
взлом: взлома
банкомат: банкомата
доступ: доступа
хранилищ: хранилище
молитв: молитвы
энтузиаст: энтузиасты
разбит: разбитые
лбы: лбы
персонал: персоналом
интел: интел
довод: доводит
абсолют: абсолюта
абсурд: абсурда
говарива: говаривал
капита: капитан
джек: джек
вороб: воробей
крайност: крайности
то: той
сущност: сущности
бюрократ: бюрократией
внутрен: внутренним
пиар: пиаром
помножен: помноженным
энтузиазм: энтузиазм
люб: любое
начинан: начинание
пуст: пусть
полезн: полезное
разгоня: разгоняет
невида: невиданных
масштаб: масштабов
разогна: разогнавшись
останов: остановиться
напомина: напоминало
слон: слона
бегущ: бегущего
джунгл: джунглям
снося: сносящего
пут: пути
некотор: некоторых
пример: примерах
русск: русскую
пословиц: пословицу
расскаж: расскажу
глав: главе глава
ностальг: ностальгия
приложен: приложения
заб: забыли забыв
июл: июле
езд: ездили
санкт: санкт
петербург: петербурге
площадк: площадке
финск: финского
залив: залива
крут: крутого
сфер: сфере
моделирован: моделирования
проектирован: проектирования
мегафон: мегафон
выкат: выкатил
прикольн: прикольный
муз: музей
мем: мемов
локальн: локальных
полянк: полянках
проход: проходили
лекц: лекции
уникальн: уникальных
спикер: спикеров
каза: казалось
впечатлен: впечатлений
затм: затмил
об: обо
окружа: окружающий
лов: ловил
покемон: покемонов
площад: площадях
парк: парках
переход: переходах
метр: метро
вокзал: вокзалах
толка: толкался
пада: падал
вреза: врезался
нежив: неживые
препятств: препятствия
прежн: прежним
пронос: проносилось
голов: голове
минимум: минимум
отмен: отменило
сия: сияющих
сверхнов: сверхновых
вспомн: вспомнить
пик: пике
интерес: интереса
канул: канули
технологическ: технологическую
основател: основателю
ларр: ларри
пейдж: пейджу пейдж
произошл: произошло
важн: важных важно
событ: событий событием
полет: полет
лун: луне
отправ: отправился
советск: советский
исследовательск: исследовательский
аппарат: аппарат
луноход: луноход
марс: марсу
автоматическ: автоматические
станц: станции
центральн: центральном
показа: показали показал
мгновен: мгновений
весн: весны
австрал: австралии
рок: рок
групп: группа группу
город: городе
лансинг: лансинге
штат: штат
мичига: мичиган
род: родился
лоуренс: лоуренс
эдвард: эдвард
выглядел: выглядела
исполня: исполняется
дел: дела дело
продажн: продажные
производств: производство
электроник: электроники
продаж: продажами продаж продажи
приход: приходилось
пересека: пересекаться
плотн: плотно
подразделен: подразделение
называ: называлось
быва: бывало
служб: службы
взаимодействова: взаимодействовать
вынес: вынесены
отдельн: отдельную
махров: махрового
иб: ибо
счита: считалось
взаимоотношен: взаимоотношения
клиент: клиентом
первичн: первичны
продава: продавать
поскольк: поскольку
парнишк: парнишкой
сейл: сейлов
уда: удалось
поня: понять
прова: провал
сша: сша
предыдущ: предыдущая
модел: моделях модели
отклик: откликов
опрос: опрос
тем: тему тема
сотрудничеств: сотрудничестве
продолж: продолжить
публикац: публикации
аналог: аналог
отлича: отличался
великобритан: великобритании
вышл: вышло
спекк: спекки
европ: европе
снима: снимали
матриц: матрицу матрицы матрица
ч: ч
феном: феномен
фантастик: фантастика
экра: экраны
кинотеатр: кинотеатров
небывал: небывалое
ставш: ставших
настоя: настоящему настоящий
культов: культовыми культового
зел: зел
на: ная
мил: миля
бойцовск: бойцовский
клуб: клуб
красот: красота
мум: мумия
сон: сонная
лощин: лощина
зв: зв
здны: здные
войн: войны
призрачн: призрачная
угроз: угроза
н: н
осозна: осознанно
выход: выход
знаков: знаковым
представлен: представление
реальност: реальности
шуток: шуток
парадокс: парадокс
иде: идеях
месс: мессии
христианств: христианства
сомнен: сомнение
картезианств: картезианства
дава: давайте
посмотр: посмотрим
порассужда: порассуждаем
следова: следовать
бел: белым
кролик: кроликом
сюд: сюда
аккаунт: аккаунт
войт: войти
регистрац: регистрация
раздел: разделы
хаб: хабы
песочниц: песочница
документ: документы
соглашен: соглашение
конфиденциальн: конфиденциальность
услуг: услуги
корпоративн: корпоративный
медийн: медийная
нативн: нативные
образовательн: образовательные
стартап: стартапам
спецпроект: спецпроекты
яндекс: яндекс
дзен: дзен
настройк: настройка
язык: языка
техническ: техническая
вернут: вернуться
верс: версию
rss: rss
valerylinkov: valerylinkov
webassembl: webassembly
web: web
yuriparfenov: yuriparfenov
amd: amd
phenom: phenom
ii: ii
x: x
electrohedgehog: electrohedgehog
ai: ai
ml: ml
droman: droman
maquina: maquina
total: total
nintendo: nintendo
ds: ds
selectel: selectel
markati: markaty
bloomberg: bloomberg
tileksamiev: tileksamiev
timeweb: timeweb
cloud: cloud
darya: darya
chuyko: chuyko
stp: stp
serverspac: serverspace
wi: wi
fi: fi
span: spanning
tree: tree
protocol: protocol
trill: trill
badcasedaili: badcasedaily
holmogorov: holmogorov
inferno: inferno
ruvd: ruvds
nix: nix
unix: unix
bell: bell
lab: labs
plan: plan
randal: randall
cloudmt: cloudmts
quanta: quanta
magazin: magazine
ru: ru
vd: vds
linux: linux
ax: ax
hannabilova: hannabilova
pornhub: pornhub
ua: ua
host: hosting
compani: company
bb: bbs
bulletin: bulletin
board: board
system: systems
playboi: playboy
tube: tube
site: sites
redtub: redtube
youporn: youporn
curl: curl
open: open
sourc: source
url: url
frontec: frontec
tekniksystem: tekniksystem
ericsson: ericsson
gpd: gpd
pocket: pocket
fydeo: fydeos
atari: atari
ibm: ibm
pc: pc
portfolio: portfolio
c: c
lcd: lcd
macintosh: macintosh
portabl: portable
cyberdyn: cyberdyne
vvvphoenix: vvvphoenix
intel: intel
exospher: exosphere
vk: vk
fest: fest
vr: vr
ar: ar
d: d
pok: pok
mon: mon
cyberpaul: cyberpaul
googl: google
ac: ac
dc: dc
r: r
develop: developer
relat: relations
divis: division
respons: response
team: team
pre: pre
sale: sales
post: post
market: marketing
group: group
smg: smg
wearabl: wearables
perform: performance
comput: computing
wilelf: wilelf
zx: zx
spectrum: spectrum
timex: timex
sinclair: sinclair
klimenski: klimensky
firstvd: firstvds
ivansychev: ivansychev
mark: marks
alizar: alizar
erwinm: erwinmal
ereinion: ereinion
dataart: dataart
facebook: facebook
twitter: twitter
telegram: telegram
youtub: youtube
habr: habr
