хабр: хабр
откр: открыть
список: список
стат: стать статьи
автор: автором автор авторы авторов
поток: потоки
разработк: разработка
администрирован: администрирование администрирования
дизайн: дизайн
менеджмент: менеджмент
маркетинг: маркетинг
научпоп: научпоп
поиск: поиск
профил: профиль
обнов: обновить
рейтинг: рейтинг
цифров: цифровые
навык: навыки
ведущ: ведущих
эксперт: экспертов
час: часов
сдела: сделать
прочтен: прочтение
мин: мин
количеств: количество количестве количества количеством
просмотр: просмотров
блог: блог
компан: компании компаний
перевод: перевод
оригина: оригинала
виртуальн: виртуальные виртуальных
файл: файлы файлов файл файла файле
журнал: журналов журналом журналами
внутрен: внутреннее
разбиен: разбиение
реальн: реальных
физическ: физических физический физическими
котор: которое которым
созда: создает создаются создается созданных
работ: работы
транзакц: транзакций
четк: четко
определен: определенного
размер: размера размер размеров
явля: является являются
фиксирова: фиксированным
компонент: компонентом
создан: создания создание
расширен: расширения
рассчитыва: рассчитывается
динамическ: динамически
основ: основе
существ: существующего
журна: журнала
нов: нового новый новой
приращен: приращения приращение приращении
числ: числится
дурн: дурная
слав: слава
заключа: заключается
больш: большое большим
вызва: вызвать
ряд: ряд ряду
пробл: проблем проблему
сред: среди
выдел: выделить выделил
существен: существенное
снижен: снижение
скорост: скорости
запуск: запуска
баз: базы базе
дан: данных
операц: операции операций
резервн: резервного резервной резервная
копирован: копирования
восстановлен: восстановления
сгененрирова: сгененрировано
дольш: дольше
процесс: процесс
привест: привести
превышен: превышению
ожидан: ожидания
ошибк: ошибкам
связа: связанным связанные
памят: памятью
цел: целому
проблем: проблемам проблемы
оптимальн: оптимальное
разделен: разделение
способ: способом
взаимодейств: взаимодействия
предыдущ: предыдущих
верс: версиях версию
увеличива: увеличивался увеличиваем
текущ: текущего текущей
покр: покрыть
объ: объем
создава: создавался создавалось
оказыва: оказывалось
зависим: зависимости
внедр: внедрил
подход: подход
равн: равно равным
мб: мб
покроет: покроет
целик: целиком
гб: гб
увеличен: увеличение увеличения
охват: охвата
объем: объема
информац: информации информацию информация
метод: метод
призва: призван
оптимизирова: оптимизировать
повыс: повысить
производительн: производительности производительностью производительность
мониторинг: мониторинг
пример: примере пример
продемонстрирова: продемонстрирован продемонстрированные
код: код кода
использова: использовать
получен: получения
команд: команда
выведет: выведет
статус: статусе
выходн: выходных
строк: строке
так: такими таких
столбц: столбцами столбце
указа: указано
активн: активным
неактивн: неактивным
частичн: частично
используем: используемым используемом
отслеживан: отслеживания
течен: течением
след: следующий следующие
запрос: запрос запросы
вернет: вернет
кажд: каждой каждого
сервер: сервере
включ: включая
средн: средний
столбец: столбец
указыва: указывать
использ: используется
например: например
коп: копии копия
контрольн: контрольной
точк: точки
может: можете
определ: определить
использован: использованием использованию
устранен: устранение
привед: приведен
реша: решать
уменьша: уменьшаем
вручн: вручную
необходим: необходимого необходимости
вывод: выводим
изменя: изменяем
параметр: параметры
автоматическ: автоматического
обрат: обратите
вниман: внимание
должн: должны
замен: заменить
соответств: соответствующими
значен: значениями значение
ваш: вашего вашей
конкретн: конкретного
случ: случая
упомина: упоминалось
ран: ранее
выполнен: выполнением
люб: любой
убед: убедитесь
актуальн: актуальная
восстанавлива: восстанавливаемая
лучш: лучшие лучших
практик: практики практик
сто: стоит
отмет: отметить
успел: успели
сформирова: сформироваться
управлен: управления управление
следова: следовать
избежа: избежать
долж: должен
соответствова: соответствовать
рабоч: рабочей
нагрузк: нагрузке
част: частых
событ: событий
прирост: прироста
установ: установите
меньш: меньшем
уменьш: уменьшить
рост: роста
мониторьт: мониторьте
регулярн: регулярной
использу: используя
выявлен: выявления
длительн: длительное
заключен: заключение
критическ: критически
аспект: аспект
значительн: значительно
повлия: повлиять
благодар: благодаря
усовершенствован: усовершенствованиям
внесен: внесенным
администратор: администраторы
сократ: сократив
приведет: приведет
сокращен: сокращению
ускорен: ускорению
повышен: повышению
общ: общего
удобств: удобства
конечн: конечных
пользовател: пользователей
материа: материал
подготовл: подготовлен
преддвер: преддверии
старт: старта
онлайн: онлайн
курс: курса
тег: теги
хаб: хабы
голос: голосов
добав: добавить
закладк: закладки
комментар: комментарии
сайт: сайт сайта
вконтакт: вконтакте
карм: карма
редактор: редактор
комментирова: комментировать
публикац: публикации
сутк: сутки
похож: похожие
дат: дата
регистрац: регистрации регистрация
март: марта
основан: основания
апрел: апреля
числен: численность
местоположен: местоположение
росс: россия
представител: представитель
аккаунт: аккаунт
войт: войти
раздел: разделы
новост: новости
песочниц: песочница
устройств: устройство
документ: документы
соглашен: соглашение
конфиденциальн: конфиденциальность
услуг: услуги
корпоративн: корпоративный
медийн: медийная
реклам: реклама
нативн: нативные
проект: проекты
образовательн: образовательные
программ: программы
стартап: стартапам
спецпроект: спецпроекты
яндекс: яндекс
дзен: дзен
настройк: настройка
язык: языка
техническ: техническая
поддержк: поддержка
вернут: вернуться
стар: старую
otu: otus
maxrokatanski: maxrokatansky
sql: sql
server: server
vlf: vlf
pinal: pinal
dave: dave
virtual: virtual
log: log
file: files file
databas: database
engin: engine
yourdatabasenam: yourdatabasename
dbcc: dbcc
loginfo: loginfo
fileid: fileid
fileoffset: fileoffset
statu: status
select: select
reus: reuse
wait: wait
desc: desc
id: id
size: size
byte: bytes
mb: mb
count: count
avg: avg
sy: sys
dm: dm
db: db
space: space
usag: usage
shrinkfil: shrinkfile
logic: logical
transact: transaction
truncateonli: truncateonly
alter: alter
modifi: modify
requir: required
filegrowth: filegrowth
growth: growth
increment: increment
ms: ms
develop: developer
sq: sq
telegram: telegram
ru: ru
facebook: facebook
twitter: twitter
vk: vk
youtub: youtube
habr: habr
