хабр: хабр
откр: открыть
список: список
стат: стать статья
автор: автором автор авторы авторов
поток: потоки
разработк: разработка
администрирован: администрирование
дизайн: дизайн
менеджмент: менеджмент
маркетинг: маркетинг
научпоп: научпоп
поиск: поиск
профил: профиль
обнов: обновить
час: часа
краж: кража кражи
учетн: учетных учетной учетные учетными
дан: данных данные данными
администратор: администратора администратором администратор
касан: касания
помощ: помощью
пут: путем
злоупотреблен: злоупотребления
прочтен: прочтение
мин: мин
количеств: количество
просмотр: просмотров
информацион: информационная информационной
безопасн: безопасность безопасности
песочниц: песочницы песочница
перевод: перевод
оригина: оригинала
скомпрометирова: скомпрометировали
хост: хост хосте хоста
может: можете
хот: хотите хотим
дела: делать
дамп: дамп
открыт: открытых открытом открытие открытием открытыми открытая открытым
парол: паролей пароли паролем пароля пароль
традицион: традиционных
метод: методов метода
например: например
след: следует следующем следующая
провер: проверить
настройк: настройки настройками настройка
делегирован: делегирования делегирование
включ: включен включены включено включена включить включая включил
позволя: позволяет
получа: получать получает получаем
вид: виде видим виду
затрагив: затрагивая
процесс: процесс процессе процессы процессов
име: имея
прав: прав правы правой
ограничен: ограниченно
текущ: текущего текущей текущими
пользовател: пользователя пользователей пользователем пользователь
защитник: защитникам защитнике
владельц: владельцам
сист: систем систему
просматрива: просматривать
сред: средах среде
оценива: оценивать
подверж: подвержены
риск: риску
техническ: технический технические техническая
бэкграунд: бэкграунд
удален: удаленный удаленно удаленное удаленная удаленном удаленному удаленного удаленным удаленными
рабоч: рабочий
стол: стол
терминальн: терминальный
сервер: сервер серверу сервера серверами сервере серверов серверы
совмест: совместим
использует: используете
устройств: устройство устройствах
присоединен: присоединенное присоединенный
домен: домену домене
подключ: подключиться подключитесь
ваш: вашей вашем
запис: записью записями записи записей
повторн: повторного повторное
ввод: ввода вводите
должн: должны
знат: знать
сеанс: сеанса сеанс
преобраз: преобразуется преобразуются
интерактивн: интерактивное
сторон: стороне стороны
важн: важно
означа: означает
отправля: отправляется
защищен: защищенный защищенной
передач: передаче
конечн: конечном
итог: итоге
понима: понимаете
ид: идем
потратьт: потратьте
угада: угадать
пойт: пойти
догада: догадались
мож: можем
реализова: реализовать реализован реализовано
злонамерен: злонамеренный
получ: получить получены получил
фонов: фоновом
режим: режиме
функц: функция
опира: опирается
компонент: компоненты компонентами
обеспечива: обеспечивают
пурист: пуристов
обрат: обратите обратитесь
вниман: внимание
аббревиатур: аббревиатуры
наход: находятся находится
одн: одном одну
уровн: уровне уровня
поставщик: поставщик
поддержк: поддержки поддержка
служб: служб службы служба службах службу
терминал: терминалов
аутентификац: аутентификации аутентификация аутентификацию аутентификацией
точн: точнее
секурлс: секурлса
цпкг: цпкг
бенджамин: бенджамин бенджамина
дельп: дельпи
напомн: напомнил
твит: твите твита
активац: активация
привод: приводит
налич: наличию наличии
памят: памяти
треб: требуются требуется
некотор: некоторые некоторых
умолчан: умолчанию
настро: настроены настроен
работа: работает работать
подсказк: подсказка
сво: свой своем своим
подключен: подключении
собствен: собственной
вероятн: вероятно
сложн: сложнее сложно
взаимодейств: взаимодействие
виртуальн: виртуальной
консол: консоли
отладк: отладка
д: д
использова: использовать использоваться
включен: включенным включения включение
вмест: вместо
поэт: поэтому
равн: равно
прочита: прочитайте
остальн: остальное
сет: сети
пройт: пройти
графическ: графического графический
пол: поле полях
клиент: клиенте клиент клиенту клиента клиентом
использ: используется используются использующих используйте использует
открыва: открывает
соответств: соответствующие
как: какие какими какую каков
найт: найти
редактор: редакторе
группов: групповой
политик: политики политике политикой политика политику
раздел: разделе разделов разделу разделы
конфигурац: конфигурация конфигурацию конфигурации
компьютер: компьютера компьютеров компьютером компьютер компьютере
административн: административные
шаблон: шаблоны
систем: система системы
явля: являются является являетесь
разреш: разрешить разрешены разрешен
запрет: запретить
активн: активными активного
определ: определены определено определил
авторизова: авторизованных авторизованы авторизованный авторизованными авторизованные авторизован авторизованному авторизованного авторизована
похож: похожие похоже
вариант: варианты варианте
разн: разных
тип: типов
нов: новые
сохранен: сохраненные
интерес: интересуют интересующего
поскольк: поскольку
аутентифицирова: аутентифицированного аутентифицировать
приним: принимая
правильн: правильно правильности
поня: понял
свеж: свежие
сохран: сохранили сохранен сохранены
хранилищ: хранилище
см: см
команд: команды команду команд команда
мног: многие многих
учебник: учебники
инструмент: инструменты
видим: видимому
изменя: изменяют
подстановочн: подстановочные подстановочный
знак: знаки знак
увидет: увидеть
сам: самое самый
префикс: префиксом
дел: деле
пользовательск: пользовательском
интерфейс: интерфейсе
упомина: упоминаются
нотац: нотация нотации
имен: имени именем
участник: участника участников
уместн: уместно
говор: говорить говорится
размещен: размещенные
им: имена имейте
связа: связаны связаться
параметр: параметры параметр
папк: папке
значен: значения значение
реестр: реестра реестр реестре
сопоставля: сопоставляется
проверк: проверкой проверка проверки
подлин: подлинности подлинность
выгляд: выглядит
настроек: настроек
установлен: установленных
выш: выше
очевидн: очевидно
сохраня: сохраняется
замет: заметили заметить заметите
флажок: флажок
объедин: объединить
ос: ос
входн: входными
установл: установлен
ключ: ключами
хран: хранятся
эквивалент: эквивалентов
мо: моих моем
кажут: кажутся
пуст: пустыми
неопределен: неопределенными
возможн: возможно возможными возможность
будущ: будущих
верс: версиях версии версию
измен: изменится изменить
предлага: предлагает предлагаемой
красив: красивого
отображен: отображения
содержим: содержимого
заключен: заключение
помн: помнить помните
обязательн: обязательными обязательно
работ: работы работа
момент: момента
факт: факт
вход: входе входа
цикл: цикл
выход: выхода
перезагрузк: перезагрузка
уверен: уверенным
конкретн: конкретная
опц: опция
зависет: зависеть
техник: технику
наскольк: насколько
сброс: сбросить
наверняк: наверняка
описан: описании
объект: объекта
указа: указано указанный указать указанное
применя: применяется
достигнут: достигнута
использован: использованием использовании
доверен: доверенного
сертификат: сертификата сертификат
перв: первому первая
ко: ко
втор: второму
могл: могли могла
обознача: обозначаются
имеет: имеет
смысл: смысл
обычн: обычный обычных
следовательн: следовательно
аргумент: аргументом аргумент
долж: должен
существова: существовать
выдач: выдачи
билет: билетов билет билета
достав: доставить
сервисн: сервисный сервисного
котор: которым которому которую
связыва: связывается
так: таким
образ: образом
дополнен: дополнение
действительн: действительным
прос: просим
наш: нашего нашим
общ: общие
идентификатор: идентификатор идентификатором
целев: целевого целевому
прост: простой
способ: способ способов
запуст: запустить
сценар: сценарий
заключа: заключается
выполнен: выполнение выполнения
код: кода кодом
украден: украденный
злоупотребля: злоупотребляете
получен: получения полученные
пример: примере
клиентск: клиентским клиентского клиентском клиентский
слев: слева
использу: используем используя
справ: справа
люб: любой любом любое
присоедин: присоединены
итак: итак
благодар: благодаря
запуска: запускаем запускаю запускаются запускал запускать
подтвержден: подтверждение подтверждения
строк: строке строка
пакет: пакет пакете
четк: четким
интересн: интересно
стран: странно
упомянул: упомянули
попроб: попробую
объясн: объясните
реализ: реализует
легч: легче
подделыва: подделывать
личност: личность
легитимн: легитимного
локальн: локально локальном локальный
демонстрац: демонстрации демонстрациях
реш: решил
обо: обоих
экземпляр: экземпляра
лев: левой левом
подтвержда: подтверждает
позвольт: позвольте
показа: показать
обознач: обозначить
обязател: обязателен
попада: попадать
цел: целей цель
существ: существующий
проверя: проверяется
разреша: разрешает
мог: могу
отправ: отправить
дополнительн: дополнительной
защит: защиту
нижн: нижнем
окн: окне
видет: видеть
привилег: привилегии
сбрасыва: сбрасывать сбрасывает
доступ: доступ
методик: методики
чьим: чьим
подключа: подключаюсь
тест: тесты
показыва: показывают показывает
устранен: устранение
неполадок: неполадок
прежд: прежде
идеальн: идеальные
результат: результаты
представлен: представленные
из: изо
сил: сил силу
пыта: пытался пытаемся
столкнул: столкнулся
нескольк: несколькими
ошибк: ошибками ошибки ошибка ошибку
объяснен: объяснениями
основа: основанными
пониман: понимании
гарант: гарантии
проблем: проблема
останавлива: останавливается
секунд: секунд
середин: середине
операц: операции
нормальн: нормальным
конц: конце концов
заверша: завершается
именова: именованных именованного именованный
канал: каналов
файл: файл
кана: канала канал
прослушива: прослушивается
забыва: забывайте
перезапуска: перезапускать
кажд: каждой каждого
попытк: попытке
неизвестн: неизвестное
неверн: неверный неверное
произойт: произойти
указыва: указывает
авториз: авторизует
доступн: доступных
происход: происходит
зна: знаю
вышл: вышли
вошл: вошли
сообщен: сообщение сообщению
явн: явно
выполн: выполнить
отсутств: отсутствует
попыта: попытается
случа: случаях случае
вернет: вернется
зарегистрирова: зарегистрировано
проверьт: проверьте
объявлен: объявленным объявленное
отлич: отличие
присутств: присутствует
отключ: отключен
детектор: детектора
обратн: обратной
связ: связи
вызовет: вызовет
друг: другого другими
расследован: расследование
либ: либо
недействител: недействителен
допустим: допустимое
серверн: серверного
олицетворен: олицетворение
сработа: сработало
ограничительн: ограничительна
нужн: нужны
хотел: хотели
проведен: проведении
пентест: пентеста
разрешен: разрешение разрешения
максимальн: максимально
избега: избегать
изменен: изменения изменение
снижен: снижение
забудьт: забудьте
отмен: отменить
первоначальн: первоначальная
стоимост: стоимость
позвол: позволит
огранич: ограничен
добав: добавив добавить
вступа: вступает
немедлен: немедленно
осторожн: осторожностью
основн: основном
отключа: отключает
взят: взяты
предлож: предложил
альтернатив: альтернативой
популяр: популярен
шанс: шансов
вызва: вызвать
тревог: тревогу
удал: удалив
возраз: возразить
эффектив: эффективен
сесс: сессиями сессия
найд: найдите
подума: подумать
решен: решении
иде: идея
состо: состоит
контекст: контексте
запущ: запущу
представ: представим
доб: добился
виж: вижу
перечисля: перечисляю
дочерн: дочерний
предпочита: предпочитаю
распоряжен: распоряжении
альтернат: альтернатив
вывод: вывод
мощн: мощно
определен: определенные
объясня: объяснялось
выда: выдать
золот: золотой
обладан: обладание
хэш: хэшем
скомпрометац: скомпрометация
сгенерирова: сгенерировать
дем: демо
особ: особо
вника: вникал
дета: детали
ясн: ясно
протокол: протокол протоколами
предполож: предположить
волшебн: волшебный
материа: материал
исходн: исходным
наслажда: наслаждайтесь
чтен: чтением
насчет: насчет
изолир: изолирует
машин: машине
называ: называемая
защища: защищает
согласн: согласно
тег: теги
хаб: хабы
рейтинг: рейтинг
закладк: закладки
комментар: комментарии
карм: карма
комментирова: комментировать
публикац: публикации
лучш: лучшие
сутк: сутки
истор: истории
специалист: специалист
ваканс: вакансий вакансии
аккаунт: аккаунт
войт: войти
регистрац: регистрация
новост: новости
компан: компании компаний
информац: информация
сайт: сайта
документ: документы
соглашен: соглашение
конфиденциальн: конфиденциальность
услуг: услуги
корпоративн: корпоративный
блог: блог
медийн: медийная
реклам: реклама
нативн: нативные
проект: проекты
образовательн: образовательные
программ: программы
стартап: стартапам
мегапроект: мегапроекты
яндекс: яндекс
дзен: дзен
язык: языка
вернут: вернуться
стар: старую
sidneyjob: sidneyjob
lsass: lsass
kekeo: kekeo
credssp: credssp
cl: cl
eacut: eacute
ment: ment
notin: notin
window: windows
sekurlsa: sekurlsa
logonpassword: logonpasswords
mimikatz: mimikatz
rdp: rdp
sso: sso
ad: ad
tsssp: tsssp
tspkg: tspkg
ssp: ssp
gentilkiwi: gentilkiwi
powershel: powershell
microsoft: microsoft
visual: visual
studio: studio
nla: nla
gpo: gpo
vault: vault
termsrv: termsrv
domain: domain
host: host
hkei: hkey
local: local
machin: machine
softwar: software
polici: policies
credentialsdeleg: credentialsdelegation
allowdefaultcredenti: allowdefaultcredentials
ntlm: ntlm
allowdefcredentialswhenntlmonli: allowdefcredentialswhenntlmonly
system: system
currentcontrolset: currentcontrolset
control: control
lsa: lsa
policydefault: policydefaults
list: list
x: x
kerbero: kerberos
spn: spn
servic: service
fqdn: fqdn
target: target
nt: nt
author: authority
tgt: tgt
client: client
lab: lab
test: test
adc: adcs
pki: pki
psexec: psexec
s: s
user: user
ticket: ticket
cif: cifs
server: server
pipe: a
b: pipe
endpoint: b
toto: endpoint
sedebug: toto
admin: sedebug
waitnamedpip: admin
e: waitnamedpipe
kdc: e
f: kdc
nltm: f
activ: nltm
directori: active
ldap: directory
reg: ldap
add: reg
hklm: add
t: hklm
dword: t
d: dword
concatenatedefault: d
allowdefault: concatenatedefaults
sz: allowdefault
allowdefntlmonli: sz
delpi: allowdefntlmonly
wdigest: delpy
delet: wdigest
regedit: delete
pid: regedit
process: pid
runp: process
run: runp
ex: run
exit: exe
benjamin: exit
bluehat: benjamin
tcp: bluehat
smb: tcp
kuhl: smb
m: kuhl
c: m
credenti: c
guard: credential
lsaiso: guard
red: lsaiso
team: red team
facebook: teaming
twitter: facebook
vk: twitter
telegram: vk
youtub: telegram
habr: youtube
