хабр: хабр
откр: открыть
список: список
стат: стать статьи статье статья
автор: автором авторы автор авторов
поток: потоки потоков
разработк: разработка разработкой разработке разработки
администрирован: администрирование администрирования
дизайн: дизайн
менеджмент: менеджмент
маркетинг: маркетинг
научпоп: научпоп
поиск: поиск поиске
профил: профиль
обнов: обновить
рейтинг: рейтинг рейтинга
прототипн: прототипно
ориентирова: ориентированный
язык: язык языках языке языка языки
программирован: программирования программирование
компан: компании компаниях компаний
подряд: подряд
скопирова: скопировать
ссылк: ссылку ссылки ссылка
показыва: показывать показывает
нов: новые новая новом
лучш: лучшие лучшего лучших
порог: порог
уровен: уровень
сложност: сложности
прост: простой прост простого простейшее простые
средн: средний
сложн: сложный
примен: применить
час: часов часа
адаптивн: адаптивный адаптивности адаптивность адаптивная адаптивным
многоязычн: многоязычный
компонент: компонент компонента компонентов
футер: футера
создан: создание созданием создания
использован: использование использования использовании использованием
прочтен: прочтение
мин: мин
количеств: количество количества
просмотр: просмотров
песочниц: песочницы песочница
занима: занимаетесь занимаюсь
блогинг: блогингом
контент: контента
нескольк: нескольких
множеств: множество множества
социальн: социальных социальные
мед: медиа
аккаунт: аккаунтов аккаунт
котор: которыми котором которое
хот: хотите
подел: поделиться поделится
понрав: понравится
дан: данный данные данной данных
разработа: разработан
учет: учетом
удобств: удобства
настраиваем: настраиваемости
автоматическ: автоматически автоматическое
отобража: отображает
иконк: иконки
нужн: нужном
подходя: подходящем
тип: типе типы типов тип
устройств: устройства устройстве устройство
минималистическ: минималистический
позволя: позволяет позволяющей
пользовател: пользователю
сосредоточ: сосредоточиться
главн: главном главными
содержим: содержимом
страниц: страницы страницу
гарантир: гарантирует
хорош: хороший
внешн: внешний
вид: вид виде видов
люб: любом любых любой
размер: размере размеров
экра: экрана
чита: читать
дал: далее дал
голос: голосов
добав: добавить
закладк: закладки
комментар: комментарии
новост: новости
рендеринг: рендеринг рендеринга
приложен: приложений приложения
пример: примерах примере пример примера
блог: блог
альф: альфа
банк: банк банке банка
веб: веб
сайт: сайтов сайта сайт
обзор: обзор
привет: привет
зовут: зовут
хаджимурад: хаджимурад
фронтенд: фронтенд
успел: успел
поработа: поработать
мног: многих
проект: проектах проекты проекте проект
интернет: интернет
магазин: магазин
панел: панели
университет: университета
работа: работаю работают работать
хоч: хочу
сво: своим свой сво
опыт: опытом
постара: постараюсь
описа: описать описанное
способ: способа способ
раскр: раскрыть
плюс: плюсы
минус: минусы
практическ: практических
провест: провести
сравнен: сравнение сравнению
производительн: производительности
материа: материал
подойд: подойд
начина: начинающим начинающих
разработчик: разработчикам разработчик разработчиков разработчиком разработчики
хочет: хочет
познаком: познакомиться познакомим
пониман: понимания
потреб: потребуются
начальн: начальные
знан: знания
менеджер: менеджеров
пакет: пакетов пакет
мар: мар
эффектн: эффектно
эффективн: эффективно эффективными эффективной
инструмент: инструментов инструменты
анимац: анимации анимаций
сбермаркет: сбермаркет сбермаркете
евген: евгений
прокоп: прокопьев
мобильн: мобильный мобильных
пят: пяти
любов: любовь
красив: красивые
рассказа: рассказать
помощ: помощью
как: каких какими какие
добива: добиваться
качествен: качественных
начн: начну
посмотр: посмотрим
внутр: внутри
расскаж: расскажу
дела: делать
библиотек: библиотеками библиотека библиотеке библиотеки библиотеку библиотек
поеха: поехали
контрибьют: контрибьютить
знаеш: знаешь
перевод: перевод
последн: последнее последних последней
нрав: нравится
сред: среда средами
исполнен: исполнения
схож: схожая
имеет: имеет
одн: одно одну одна
преимуществ: преимущество преимуществ преимуществами
друг: другими другим
важн: важно
быстр: быстрый быстро
запуск: запуск запуска
крайн: крайней
мер: мере
вперв: впервые
запуст: запустил
небольш: небольшой
кусок: кусок
код: кода коде код
повер: поверить
переш: переш
л: л
оттолкнул: оттолкнуло
тест: тесты тестов теста
выполня: выполняются выполняться
медлен: медленно
написан: написание
то: той
бизнес: бизнес
логик: логики
тестирован: тестирование
совершен: совершенно совершенный
разн: разный разных разного
оп: опыт
неудивительн: неудивительно
сообществ: сообщество
ненавид: ненавидит
юн: юнит
дума: думать думали
например: например
распределя: распределять распределяешь
файл: файлов
причин: причина
оптимизирова: оптимизировали
выполнен: выполнения
наподоб: наподобие
прогон: прогон
чрезвычайн: чрезвычайно
разрешен: разрешения
модул: модулей
треб: требуется требует
куч: куча
работ: работу работы работа
процесс: процессов процесс процессом
использова: использовать
ядр: ядра
ещ: ещ
ресурс: ресурсов
истор: истории
гугл: гугл
таблиц: таблица таблиц таблицы
бд: бд
телегр: телеграм
бот: бота ботом
продолжен: продолжение продолжением
туториа: туториал
качеств: качестве
кратк: краткое кратко
предислов: предисловие
предыдущ: предыдущем
пост: посте
привел: привела
забира: забирать
текст: текст
ячеек: ячеек
отправля: отправлять отправляли
отдельн: отдельных
сообщен: сообщений сообщениями
чат: чат чаты
обеща: обещала
преврат: превратить
кнопк: кнопки
размест: разместив
успешн: успешно
возможн: возможности возможностям возможностях возможностей возможно
част: часть части
представля: представляю представляющий
ваш: вашему
вниман: вниманию внимание
замечательн: замечательной
посвящен: посвященной
трех: трех
могл: могли
пропуст: пропустить
перв: первой первую первая
говор: говорили говоря
поговор: поговорим
втор: вторая
обрат: обратите
назван: названия
соответств: соответствующие соответствующий
раздел: разделы раздел
документац: документации
руководств: руководства руководство руководстве руководству
шпаргалк: шпаргалки
вопрос: вопросы
материал: материалы
технолог: технологиям
микрофронтенд: микрофронтенды микрофронтендов
ростелек: ростелеком
кейс: кейс
представ: представить
решен: решение решения решений
внедрен: внедрению внедрении
рт: рт
мис: мис
связа: связать
написа: написанные написать
пробл: проблем проблему
выбра: выбрали выбрать
проблем: проблемами
столкнул: столкнулись
привед: приведу
техническ: технической технические техническая
реализац: реализации реализацией
подход: подходы подходят
подошл: подошли
бесплатн: бесплатно
яндекс: яндекс
практикум: практикум практикума
учебн: учебный
момент: момента
мо: моей моем
публикац: публикации
прошл: прошло
получ: получилось получить получил
уда: удалось
тикет: тикет
курс: курс курса
программ: программе программы
цифров: цифровые
професс: профессии
хотел: хотел
полезн: полезна
тру: тру
верстальщик: верстальщикам
джун: джунам
фронтендер: фронтендерам фронтендеров
обучен: обучения
стек: стеке
нача: начало
нативн: нативный нативные
браузерн: браузерные
событ: события
верстк: верстка
навык: навыки
вектор: вектором
растров: растровыми
изображен: изображениями
попаст: попасть
пройт: пройти
предварительн: предварительное
этап: этапов
интерв: интервью
известн: известно известны
попада: попадают
критер: критерии
отбор: отбора
будьт: будьте
готов: готовы
вс: вс
шаблон: шаблоны шаблонного
стран: странные странный странах
здравств: здравствуйте
дмитр: дмитрий
карловск: карловский
дуб: дуб
пуст: пустил
корн: корни
адепт: адептов
свят: святого
выращива: выращиваю
сверх: сверх
люд: людей
способн: способных
сбрасыва: сбрасывать
был: былые
привычк: привычки
убежден: убеждения
пуска: пускать
побег: побеги
свеж: свежих
ид: идей
базир: базирующихся
прочн: прочном
рациональн: рациональном
основан: основании
позвольт: позвольте
посея: посеять
зерн: зерно
сомнен: сомнения
правильн: правильности
традицион: традиционных
показа: показать
синтаксис: синтаксис
композиц: композиции
задач: задачи задачу задача
человек: человеком
буфер: буфером буфер
копирова: копировать
картинк: картинки
класт: класть
поддержк: поддержка
кастомн: кастомных
сдела: сделать
встав: вставить
конец: конец
искусствен: искусственный
интеллект: интеллект
мнен: мнение
больш: большие
языков: языковые
модел: модели
угрожа: угрожающей
скорост: скоростью
станов: становятся становится становиться
пар: пару
понадоб: понадобятся
позиц: позиция позиции
вирусн: вирусной
твиттер: твиттере
горазд: гораздо
оптимистичн: оптимистично
смотр: смотрю
достижен: достижения
и: ии
означа: означают
будущ: будущего
программн: программного
обеспечен: обеспечения
карт: карты
пошагов: пошаговое
графическ: графический
мощн: мощный
представлен: представления
движен: движения
объект: объектов
различн: различными различные
географическ: географическими
локац: локациями
легк: легко
реализ: реализуется
сут: сути
совмеща: совмещают
функциональн: функциональность
потоков: потоковой
диаграмм: диаграммы
визуализац: визуализации
направлен: направление
товар: товаров
денег: денег
информац: информации информация
текущ: текущем
практичн: практичным
использу: используем
студент: студентов
инд: индии
обуча: обучающихся
следу: следуя
науч: научитесь
создава: создавать
собствен: собственные
калькулятор: калькулятора
добр: доброго
суток: суток
уважа: уважаемый
ил: илья
откровен: откровенно
иска: искал
повод: повод
опубликова: опубликовать
похож: похоже
наста: настал
сраз: сразу
предупреж: предупрежу
счита: считаю
мет: метой
истин: истинно
верн: верным
срочн: срочно
посчита: посчитать
строк: строку
содержа: содержащую содержащие
математическ: математические
выражен: выражения
скобок: скобок
сильн: сильно
упрост: упростить
формат: формат
н: н
аналитик: аналитика
изобр: изобр
глаз: глаза
кровоточ: кровоточили
гляд: глядя
всяк: всяком
случа: случае
ощущен: ощущение
слож: сложиться
почита: почитать
род: рода
обраща: обращаться
первоисточник: первоисточникам
вытека: вытекают
чист: чисто чистом
прагматическ: прагматических
рассужден: рассуждений
так: таких
анализ: анализов
вколот: вколоть
прививк: прививку
бешенств: бешенства
универсальн: универсальный универсальную
созда: создать создала
стартап: стартап стартапу стартапам
кажд: каждому каждого
нуж: нужен
лендинг: лендинг
вверх: вверху
хедер: хедер хедеры
мен: меню
навигац: навигации
обязательн: обязательно
одинаков: одинаково
компьютер: компьютерах
телефон: телефонах
планшет: планшетах
тысяч: тысячи
разрабатыва: разрабатывают
трат: тратя
имеют: имеют
функциона: функционал функционала
порт: порт
вменя: вменяемой
реш: решить
подключен: подключением
уйм: уйму
подума: подумала
реализова: реализовала
большинств: большинство
фич: фич
потребова: потребоваться
пиш: пишем
мессенджер: мессенджер мессенджеры мессенджера
ких: ких
узна: узнайте
установ: установить
ч: ч
различ: различие
запрос: запросами
сервер: сервер
клиент: клиент
полност: полностью
стайлинг: стайлинга
замен: заменить
сист: систем
втб: втб
вад: вадим
казаченк: казаченко
лид: лид
фронт: фронта
систем: системы
устро: устроился
командн: командную
постро: построить
един: единую
настольк: настолько
продукт: продукте
должн: должна
узк: узким
горлышк: горлышком
происход: происходит
кит: китами
крупн: крупных
дел: дело деле
существ: существует
десятк: десятки
дизайнер: дизайнеров
непрост: непростая
требова: требовала
проработк: проработки
архитектур: архитектуры
зависел: зависела
выбор: выбора выбор
подробн: подробно
отталкива: отталкивались
останов: остановили
сравнива: сравниваем сравнивать
структур: структуры
глубок: глубоко
микроскопическ: микроскопических
сам: самых
шустр: шустрых
класс: классе
умеющ: умеющая
произвольн: произвольные
циклическ: циклические
уд: уда
тся: тся
погруз: погрузиться
поглубж: поглубже
умира: умирает
зайд: зайдя
официальн: официальный
поня: понял
произошл: произошло
заход: заходим
установк: установки
мож: можем
увидет: увидеть
предложен: предложенные
вариант: варианты варианта
фреймворк: фреймворков
явн: явного
неужел: неужели
сдает: сдает
дава: давайте
разбер: разберемся
настоя: настоящее
собира: собираются
интересн: интересная интересно
схем: схема схеме схемы
форм: формами форм
назов: назовем
сегодняшн: сегодняшний
предполага: предполагает
обработк: обработки
валидац: валидации
пользовательск: пользовательских
применен: применение
существен: существенных
необходим: необходимого
вручн: вручную
явля: являются
минимизац: минимизация
выведен: выведение
интерес: интересует
репозитор: репозиторий
прош: прошу
кат: кат
сюд: сюда
вклад: вклад
ваканс: вакансий вакансии
войт: войти
регистрац: регистрация
хаб: хабы
документ: документы
соглашен: соглашение
конфиденциальн: конфиденциальность
услуг: услуги
корпоративн: корпоративный
медийн: медийная
реклам: реклама
образовательн: образовательные
мегапроект: мегапроекты
дзен: дзен
настройк: настройка
вернут: вернуться
стар: старую
верс: версию
javascript: javascript
rss: rss
vuewebdev: vuewebdev
vue: vue
vuej: vuejs
khidirbekov: khidirbekov
csr: csr
ssg: ssg
ssr: ssr
html: html
reactj: reactjs
c: c
react: react
npm: npm
yarn: yarn
evgen: evgen
nativ: native
anim: animated
reanim: reanimated
svg: svg
lott: lotte
opengl: opengl
skia: skia
ru: ru
vd: vds
ruvd: ruvds
open: open
sourc: source
github: github
bun: bun
typescript: typescript
deno: deno
node: node
js: js
rubi: ruby
vitest: vitest
jest: jest
ava: ava
watch: watch
nadjuscha: nadjuscha
api: api
aio: aio
timeweb: timeweb
cloud: cloud
world: world
ts: ts
express: express
prisma: prisma
graphql: graphql
docker: docker
yanabutorina: yanabutorina
extj: extjs
sencha: sencha
custom: custom
element: elements
kan: kan
middl: middle
frontend: frontend
recoveri: recovery
mode: mode
dom: dom
ajax: ajax
scss: scss
gulp: gulp
nin: nin
jin: jin
mol: mol
alex: alex
bbb: bbb
ctrl: ctrl
evgeniypp: evgeniypp
gpt: gpt
bright: bright
translat: translate
css: css
ilik: iliks
eval: eval
liubov: liubov
respons: responsive
header: header
temurumaru: temurumaru
php: php
websocket: websocket
http: http
vad: vad
ui: ui
compar: compare
deep: deep
idmx: idmx
creat: create
app: app
remix: remix
expo: expo
gatsbi: gatsby
hook: hook
form: form
zod: zod
type: type
infer: inference
alexzfort: alexzfort
ilusha: ilusha
sergeevich: sergeevich
azproduct: azproduction
alizar: alizar
phillennium: phillennium
theshock: theshock
spmbt: spmbt
glebmachin: glebmachine
facebook: facebook
twitter: twitter
vk: vk
telegram: telegram
youtub: youtube
habr: habr
