хабр: хабр знакомым
откр: открыть
список: список
стат: стать
автор: автором компании сайта
поток: потоки
разработк: разработка разработки
администрирован: администрирование
дизайн: дизайн
менеджмент: менеджмент
маркетинг: маркетинг
научпоп: научпоп
поиск: поиск
профил: профиль
обнов: обновить
час: час
демосц: демосцена демосцены
релейн: релейном релейный релейного
компьютер: компьютере компьютер проекта
прочтен: прочтение
мин: мин
количеств: количество
просмотр: просмотров
ненормальн: ненормальное
программирован: программирование
работ: работа работу
виде: видео
график: графикой
туториа: туториал
обрат: обратимся
классик: классике
мо: моего
визит: визита
удивля: удивлялся
голосован: голосования
непонятн: непонятно
стольк: столько
люд: людей
отдава: отдавать
голос: голоса
состоя: состоящие
туп: тупой
последовательн: последовательности
эффект: эффектов эффект
плазм: плазмы
туннел: туннеля
огн: огня
куб: куба
подобн: подобных
вещ: вещей
объединен: объединенных
никак: никаким никакой
сюжет: сюжетом
несущ: несущими
ид: идеи
возьм: возьм
попа: попавшийся
понадела: понаделаем
движущ: движущаяся движущиеся
синусоид: синусоида синусоиду синусоиды
всяк: всякие безо
крив: кривые кривой кривую
встеча: встечаются
кажд: каждом каждого каждой
втор: втором вторая
дем: демо
форм: форма
меня: меняется
бега: бегают
букв: буквы
множеств: множество
красочн: красочных
вариант: вариантов
функц: функцию
синус: синуса
посчита: посчитать посчитанных
восьмибитн: восьмибитных
машин: машинах
быстр: быстро
рисова: рисовать
перерисовыва: перерисовывать
получ: получится знания вроде
программ: программе программы
бейсик: бейсике
одн: одну
секунд: секунд
оптимизирова: оптимизировать
вывод: вывод
экра: экран экрана
расч: расч
вс: вс
равн: равно
медлен: медленно медленным
выход: выход
использован: использование
таблиц: таблицы таблицу
заран: заранее
значен: значений значения значениями
вбива: вбивать
рук: руками
алгоритм: алгоритмом алгоритм
эконом: экономить
считыв: считывая
готов: готовые готовую
выбор: выбор
запуска: запускать
этап: этапе
вставл: вставляя
исходн: исходный
бинарн: бинарный
файл: файл
либ: либо
инициализац: инициализации
перв: первого
способ: способа
генератор: генераторы
дающ: дающие
примерн: примерно
результат: результат
част: часть
треб: требует требуется
особен: особенного
подход: подхода
рисован: рисование
экран: экране
двига: двигалась телевизору
постоя: постоянно
обновля: обновлять
картинк: картинку
пиксел: пикселей пиксель
положен: положение
точек: точек
пересчитыва: пересчитывать
например: например
хот: хотим
устро: устроить
скроллинг: скроллинг
копирова: копировать
цвет: цвета цветов цвет
справ: справа всяких
налев: налево
занов: заново
вычисля: вычислять вычисляются
сам: самый
прав: правый
столбец: столбец
изображен: изображения
настольк: настолько
использ: используется пространстче
игр: играх
пример: примеру
аппаратн: аппаратная
поддержк: поддержка
фрагмент: фрагмент
наш: нашего
огон: огонь
сдела: сделать
сложн: сложно волнообразно
смотр: смотрится
красив: красиво
генерац: генерации
похож: похож сутки
клеточн: клеточного
автомат: автомата
след: следующего
поколен: поколения
основ: основе
предыдущ: предыдущего
начина: начинает
горет: гореть
сниз: снизу
последн: последний
ряд: ряд
заполня: заполняется
случайн: случайными появляющиеся затухать
величин: величина случайную
котор: которую
хран: хранит
обознача: обозначать
яркост: яркость
ч: ч
рног: рного
красн: красный
оранжев: оранжевый
лты: лтый
бел: белому
плам: пламя
поднима: поднимается точки слева
поэт: поэтому
нов: новые
строк: строки строку бегущая бегущих бегущей
использу: используя
наход: находится
появля: ним
точк: случайные
ещ: подниматься
затуха: ещ
оста: величину
использова: осталось
слев: использовать
колеба: поднималось
примен: колебалось
знан: применить
бегущ: получим встречались традиционно
символ: строка
встреча: символов поверхности
мног: встречалась лабиринт
демк: многих
ровн: демках
выпуск: ровные
новост: выпуске разделы
телевизор: новостей
волнообразн: двигались
тр: сложной
хмерн: тр поновее координат
поверхн: хмерной
одновремен: строк
традицион: одновременно выведем
передава: строке
привет: передавали
друз: приветы
знаком: друзьям
вывед: хабре
лабиринт: традиционное хмерные
спрашива: многие
запуст: спрашивают
понов: запустить
представлен: лабиринты
координат: представления
пространстч: хмерном
черыр: используются
вектор: черыр
преобразован: вектора
поворот: преобразования
сдвиг: поворот
представ: сдвиг
помощ: представить
умножен: помощью
матриц: умножения
современ: матрицу
процессор: современные
включа: процессоры
набор: включают
инструкц: набор тов
ускорен: инструкций
так: ускорения
тов: таких
созда: инструкции
свод: созданы
программист: сводить системный
ум: программистов
прост: ума
арифметическ: просты
логическ: арифметические
команд: логические
хардкор: команды
кармак: хардкор
написа: кармак
без: написал
ребят: справимся
врод: ребята
отличн: получилось
релюх: отличное
щ: релюхами
лкает: щ
ваш: лкает
микросхем: вашими
страниц: микросхемами
проект: страница нативные
эмулятор: компьютера
тег: эмулятор
апрел: теги
хаб: апреля
рейтинг: хабы
добав: рейтинг
закладк: добавить
комментар: закладки
карм: комментарии
павел: карма
довгалюк: павел
системн: довгалюк
задонат: программист
сайт: задонатить устройство
публикац: сайт
лучш: публикации
сутк: лучшие
истор: похожие
аккаунт: истории
войт: аккаунт
регистрац: войти
раздел: регистрация
компан: новости авторов
песочниц: авторы
информац: песочница
устройств: информация
документ: компаний
соглашен: документы
конфиденциальн: соглашение
услуг: конфиденциальность
корпоративн: услуги
блог: корпоративный
медийн: блог
реклам: медийная
нативн: реклама
образовательн: проекты
стартап: образовательные
мегапроект: стартапам
яндекс: мегапроекты
дзен: яндекс
настройк: дзен
язык: настройка
техническ: языка
вернут: техническая
стар: вернуться
верс: старую
dovgaluk: dovgaluk
assembl: assembler assembly
d: d
manw: manwe
sand: sands
frog: frog
demo: demo
parti: party
spectrum: spectrum
formula: formula
sin: sin
pi: pi
t: t
const: const
int: int
lut: lut
commodor: commodore
c: c
ne: nes
color: color
x: x
y: y
dec: dec
rand: rand
habr: habr
doom: doom
zx: zx
monster: monster
maze: maze
z: z
mmx: mmx
realiti: reality
http: https
dovgalyuk: dovgalyuk
github: github
io: io
relai: relay fistful
ttxine: ttxine
relayemul: relayemulator
fist: a
facebook: relays
twitter: facebook
vk: twitter
telegram: vk
youtub: telegram
