хабр: хабр хабре хабра
откр: открыть
список: список
стат: стать статьи статью статье статья статьях
автор: автором авторы авторов
поток: потоки потока поток потоков
разработк: разработка разработкой разработки разработках разработке
администрирован: администрирование
дизайн: дизайн
менеджмент: менеджмент менеджмента
маркетинг: маркетинг
научпоп: научпоп
поиск: поиск поиску поиска
профил: профиль
обнов: обновить
поддержк: поддержке поддержка
рейтинг: рейтинг рейтинга
машин: машинное машины машинного машинным
обучен: обучение обученную обучения обучением
основ: основа основы основе
искусствен: искусственного искусственный искусственные искусственным
интеллект: интеллекта интеллект интеллектом
компан: компании компаний
подряд: подряд
скопирова: скопировать
ссылк: ссылку
показыва: показывать показывают
нов: новые новый новую
лучш: лучшие лучшее лучший лучшей лучших
порог: порог
уровен: уровень
сложност: сложности
прост: простой простого простом простую простых
средн: средний среднего среднем
сложн: сложный сложно сложных
примен: применить
час: часов часа
генеративн: генеративно генеративное генеративный
состязательн: состязательных
сет: сетей сети сеть сетях
прочтен: прочтение
мин: мин
количеств: количество количества
просмотр: просмотров
кейс: кейс
высок: высоком высокая
уровн: уровне уровня
нейрон: нейронные нейронной нейронных нейронную
учат: учатся
генерирова: генерировать
реалистичн: реалистичные
образц: образцы
дан: данных данная данному данном данный данные
обуча: обучались обучается
например: например
име: имея
фотограф: фотографии
рукописн: рукописных
цифр: цифр
узна: узнают узнать
создава: создавать создавали
больш: большего большое большой большей больших
впечатляющ: впечатляюще
науч: научиться
люд: людей
приведен: приведенные
чита: читать
дал: далее
голос: голосов
добав: добавить
закладк: закладки
комментар: комментарии
новост: новости новостей
забыва: забывать
встреча: встречайте встречается встречаются
фрактал: фракталы
постепен: постепенно
увеличива: увеличиваем
разрешен: разрешение разрешенным разрешения
математик: математика
здравств: здравствуйте
зовут: зовут
никола: николай
стрекопыт: стрекопытов
придума: придумал
подбира: подбирать подбирающую
гиперпараметр: гиперпараметры гиперпараметров
бескомпромиссн: бескомпромиссно
измен: изменить изменит
порядок: порядок
вычислен: вычислений вычислениями
заявк: заявка
обновлен: обновление
индустриальн: индустриального
стандарт: стандарта
скор: скоро
сможет: сможете сможет
улучш: улучшить
пайплайн: пайплайны пайплайн
замен: заменой
нескольк: нескольких
строчек: строчек
код: кода кодом
нейросетев: нейросетевое нейросетевой
искусств: искусство
программист: программисту
художник: художником
блог: блог
конференц: конференции
наверняк: наверняка
глубок: глубоко глубокие
изуч: изучившие
генерац: генерацию генерация
картинок: картинок
помощ: помощью
нейросет: нейросетей нейросети нейросеть
ещ: ещ
разбира: разбирался
назван: названии
слов: слово
диффуз: диффузия
разновидн: разновидности
различа: различаются
гот: готов
забира: забираться
дебр: дебри
хочет: хочет хочется
присест: присест
наверста: наверстать
вс: вс
главн: главное
полез: полезен
доклад: доклад докладу докладов докладами доклады
дмитр: дмитрия
сошников: сошникова
наш: нашего нашей нашу
мероприят: мероприятия
поэт: поэтому
сдела: сделали сделана сделать
текстов: текстовую
расшифровк: расшифровку
видеозап: видеозапись
прилага: прилагаем
полгод: полгода
успел: успели
разв: развиться
сильн: сильнее
тем: тема
интересн: интересна интересно интересны интересных
заодн: заодно
порекоменду: порекомендуем
след: следующий следующие следуют
пройд: пройд
завтр: завтра
апрел: апреля
цел: целый целью
ряд: ряд
числ: числе
участ: участие
бесплатн: бесплатно бесплатный
повествован: повествование
ид: ид идеи
лиц: лица лиц лицо
част: часть части
перевод: перевод перевода
баз: базе
работ: работу работы работа
матричн: матричными
операц: операциями операций
туториа: туториал
перв: первой первое
перевел: перевел
модел: модель моделями моделей модели моделях
полносвязн: полносвязной полносвязная
разработа: разработана
новостн: новостного
агрегатор: агрегатора
фильтрац: фильтрации
нежелательн: нежелательных
посмотрет: посмотреть
руководств: руководство
увидет: увидеть
рекомендац: рекомендаций
классификац: классификации классификацию
тест: теста
явля: является являются
использован: использование использования использованием
долг: долгой
краткосрочн: краткосрочной
памят: памяти
забег: забегая
вперед: вперед
скаж: скажу
подошл: подошла
вероятн: вероятно
особен: особенность особенности
мо: моего
датасет: датасета
эмбеддин: эмбеддином
облада: обладает обладают
хорош: хорошим
качеств: качеством качество
предсказуем: предсказуемостью
стабильн: стабильностью стабильности
результат: результатов результате результат результата
объясним: объяснимое
переобучен: переобучение
влиян: влияние
архитектур: архитектуры архитектур архитектуру
д: д
немаловажн: немаловажно
быстр: быстро быстрее
отлич: отличие
рад: ради
академическ: академического
интерес: интереса
обуч: обучим
бинарон: бинароной
текст: текста тексте тексты текст
перевед: переведем
матриц: матрицами
наглядн: наглядно
покажет: покажет
устро: устроены
ячейк: ячейки
истор: истории историю история
подход: подходы подход
похож: похожих похож
изображен: изображений изображения
программирован: программирование
алгоритм: алгоритмы алгоритм алгоритма алгоритме
обработк: обработка обработки
сезон: сезон
привет: привет
паймер: паймеров
владимир: владимир
участник: участник участниками
профессиональн: профессионального
сообществ: сообщества
компьютерн: компьютерное
зрен: зрение
активн: активно
развива: развивающаяся развиваются развивать развивающихся
научн: научная научно
област: область области областью областей
связа: связанная
анализ: анализом анализ анализа
виде: видео
последн: последнее
направлен: направлению направлении
уделя: уделяется
вниман: внимание внимания
позволя: позволяет позволяющие
реша: решать
множеств: множество
задач: задач задачей задачах задаче
так: таких такого таким
детекц: детекцию детекция детекции
объект: объектов
распознаван: распознавание
очеред: очередь
применя: применяются применяться применять
разн: разных разным разные
сфер: сферах сферы сфера сфере
жизн: жизни
мобильн: мобильных
приложен: приложений
наложен: наложения
масок: масок
звонк: звонка
построен: построения
сист: систем систему
безопасн: безопасности безопасность
преступник: преступников
мошенник: мошенников
инструмент: инструменты инструментов инструмент
хран: хранить
объ: объем
обрабатыва: обрабатывать
появ: появилось
решен: решения решение решений решением
различн: различных
рассказа: рассказано рассказать
пост: посте
упрост: упростить
запуск: запуск запуска
сценар: сценарии
готов: готовой готовое готовы
виртуальн: виртуальной виртуальных
аналитик: аналитики аналитикам
поход: походы
вещ: вещь
непредсказуем: непредсказуемая
полезн: полезная полезна
нагрузк: нагрузка
распределя: распределяется
вмешива: вмешивается
элемент: элемент
случайн: случайности
забывчив: забывчивости
ситуац: ситуациях ситуация ситуации
выруча: выручает
швейцарск: швейцарский
нож: нож ножа
гарантир: гарантирует
минимальн: минимальные минимальной
потребн: потребности
групп: группы группе
удовлетвор: удовлетворены
консерв: консервы
бинт: бинт
разреза: разрезать
эконом: экономит
мест: место месте
рюкзак: рюкзаке
небольш: небольшой небольшую
команд: команде команда команды команд
работа: работает работаю работаем работают работающих
базов: базовых
собира: собирать
самостоятельн: самостоятельно
отдельн: отдельных отдельные отдельно
компонент: компонентов
удобн: удобно
дор: дорого
существова: существовало
как: какое каков
компактн: компактное
котор: котором которое
сраз: сразу
набор: набор наборов
настроек: настроек
усажива: усаживайтесь
костр: костра
поудобн: поудобнее
пришл: пришло пришла
библиотек: библиотека библиотеки библиотек
деревяшек: деревяшек
втб: втб
рожден: рождение
мног: многих многие
фреймворк: фреймворков фреймворках
нача: началось начали
автоматизац: автоматизации
рутин: рутинных
момент: момент
бинарн: бинарной
продукт: продуктам продуктов продукта
банк: банка банк
одн: одни одному
скрипт: скрипты скриптов
писа: писать
скучн: скучно
накоп: накопилось
разрознен: разрозненных
хотел: хотелось хотел
привест: привести
един: единому
формат: формату
получ: получилось
ассоциативн: ассоциативная
памя: память
ко: ко
иде: идея
реализова: реализовать реализованных
основа: основанный основаны основан основанного основанные
цепочк: цепочках цепочки
символ: символов символы
выделя: выделяет
последовательн: последовательностей последовательности последовательность последовательностью
образ: образом
производ: производит
мер: мере
метод: метод методов
грамн: грамной
разниц: разница разницу
стро: строит строить
перемен: переменной
длин: длины длинные
дела: делается делать
расскаж: расскажу
сравнива: сравнивать
друг: друг другом
наход: находить
степен: степень
похожест: похожести
приспособ: приспособил
отсеива: отсеивать
ран: ранее
известн: известные известного известной
выбира: выбирать
наибольш: наибольшей
уникальн: уникальностью
вкратц: вкратце
выдел: выделить
видн: видно
раз: раза разу
кажд: каждом
случа: случае
счита: считается
конфликт: конфликтом конфликт конфликтов
необходим: необходимо
разреш: разрешить
созда: создаются создали создают создать
трех: трех
неоднозначн: неоднозначностей
наблюда: наблюдается
разумеет: разумеется
обычн: обычном
написа: написанном написаны
человеческ: человеческом
язык: языке язык языка
потребова: потребоваться
постро: построить построили
горазд: гораздо
найт: найти
вспомн: вспомнил
попробова: попробовал
исследова: исследовать
поподробн: поподробнее
мар: мар
классическ: классических
банковск: банковских
открыт: открытие открытым открытость
финанс: финансы
связ: связи
дат: дата
сайентист: сайентисты
ива: иван
кондрак: кондраков
константин: константин
грушин: грушин
прошл: прошлой прошлого
рассказыва: рассказывали
позвол: позволило позволить
повыс: повысить
эффективн: эффективность эффективные
проверк: проверке
гипотез: гипотез
ознаком: ознакомиться
знает: знаете
занима: занимается заниматься
развит: развитием развитие развития развитию развитии
пул: пула
принят: принятия
выдач: выдаче
кредитн: кредитных
гарант: гарантий
мал: малого малом
бизнес: бизнеса бизнесу бизнесе
наста: настало
поговор: поговорить
использ: используется используются
достаточн: достаточно
точн: точно
подел: поделиться поделились поделюсь
существен: существенный
вклад: вклад
универсальн: универсального универсальные
внес: внес
член: член
расчет: расчет
транспортн: транспортного
обзор: обзор
хот: хотим хотите
сохран: сохранить
нерв: нервы
подсчет: подсчету
трафик: трафика
перекрестк: перекрестках
яросла: ярослав
никит: никита
инженер: инженеры инженерам
шаг: шага шагам
поможет: поможет
подойт: подойти
релиз: релизу релизы
потер: потерей
денег: денег
начина: начинающим начинать начинаем
продуктолог: продуктологам
владельц: владельцам
маркетолог: маркетологам
проджект: проджект
менеджер: менеджерам
шут: шути
хайпов: хайповая
кибератак: кибератаках
иб: иб
лаборатор: лаборатория лаборатории лабораторий
касперск: касперского
информацион: информационная
пожал: пожалуй
набалова: набаловались
максимальн: максимально
серьезн: серьезно
технолог: технологии технологий
влия: влияют
включ: включая
кибербезопасн: кибербезопасность
сам: самая самым самых
целев: целевых
атак: атак атаки
компрометац: компрометации
помога: помогать
детектирован: детектировании
угроз: угроз
пользова: пользоваться
син: синие
красн: красные
картинк: картинка
совместн: совместной
тимлид: тимлида
владисла: владислав
тушкан: тушканов
виктор: виктор
серге: сергеев
покажут: покажут
способн: способна
подсказа: подсказать
злоумышленник: злоумышленникам
специалист: специалистам специалистов
меня: меняет менять
отрасл: отрасль отраслях
сервис: сервису сервисе
плох: плохо
разладок: разладок
яндекс: яндекс
производительн: производительность
проектирован: проектирование
люб: любую любого
высоконагружен: высоконагруженную
ежесекундн: ежесекундно
проход: проходит
огромн: огромный
хотфикс: хотфиксы
невалидн: невалидные
ухудша: ухудшающие
эксперимент: эксперименты
событ: события
проблем: проблемам проблема
пользовател: пользователей
терп: терпят
задержек: задержек
провест: провести
аналог: аналогию
заболел: заболели
минимизирова: минимизировать
побочн: побочные
эффект: эффекты
процесс: процессе процесс процессов
выздоровлен: выздоровления
баннерн: баннерная
крутилк: крутилка
маркетплейс: маркетплейс
онлайн: онлайн
доставк: доставка
пицц: пиццы
точилин: точилин
рекламн: рекламных
вмест: вместе
сво: своим
коллег: коллегой
александр: александром
самусенк: самусенко
прод: проде
систем: системой системы
кластер: кластеры
превыша: превышает
прочита: прочитать
разработчик: разработчикам
итм: итмо
оптимизац: оптимизация оптимизации
графов: графовых
структур: структур
показательн: показательна
успешн: успешно успешных
проект: проектов проекты проектом
исходн: исходным
отличн: отличная
тенденц: тенденция
поскольк: поскольку
сторон: сторонним стороны
исследовател: исследователям
поня: понять
использова: использовать
собствен: собственных
и: ии
предметн: предметной
удел: уделяя
подготовк: подготовке
университет: университет университета
поддержива: поддерживает
курс: курс курса
собра: собрали
подборк: подборку
предназначен: предназначенных
сотрудник: сотрудники
ограничен: ограниченные ограниченных
расшир: расширяя
спектр: спектр
возможн: возможных возможно возможностей возможностями возможность
применен: применений
стандартн: стандартного
стек: стека
граф: графов
поучаствова: поучаствовать
дальн: дальнейшем
многоклассов: многоклассовая
клеток: клеток
рак: рака
почк: почки
ассистент: ассистент
врач: врача
патоморфолог: патоморфолога
арсен: арсений
студент: студент
магистратур: магистратуры
сеченовск: сеченовского
специальн: специальности
наноматериа: наноматериал
биофотоник: биофотоника
октябр: октябре
заня: занял
всероссийск: всероссийском
межвузовск: межвузовском
конкурс: конкурсе
ядер: ядер
светл: светло
клеточн: клеточного
почечн: почечно
подробн: подробностями подробно
обраща: обращать
будущ: будущее
сто: стоят
вступ: вступили
эпох: эпоху
некотор: некоторых некоторые
професс: профессий
чувствова: чувствовать
конкуренц: конкуренцию
программн: программных
происход: происходит
пошел: пошел
дума: думаю
вряд: вряд
удаст: удастся
останов: остановить
крупн: крупные
оптимизир: оптимизируют
расход: расходы
зарплат: зарплату
работник: работников
прогресс: прогресс прогресса
придержива: придерживаются
основн: основную основном
выполня: выполняют
компьютер: компьютеры
бухгалтер: бухгалтерии
учет: учета
выполнен: выполнения
зада: заданных
статическ: статическими
правил: правилами
врод: вроде
слож: сложилась
предположен: предположения
счет: счет
сказыва: сказывается
инерц: инерция
мышлен: мышления
заставля: заставляет
мысл: мыслить
шаблон: шаблонами
человек: человека
смог: смог
заработа: заработать
миллион: миллион
доллар: долларов
получен: получением
миллиард: миллиарда
сталкива: сталкиваются
предел: пределом
переступ: переступить
состоян: состоянии
медлен: медленным
мнен: мнению
рост: ростом
очевидн: очевидно
вол: волей
невол: неволей
приход: приходится
подума: подумать
приобща: приобщаться
вершин: вершине
техническ: технического техническая
вход: входа
реальн: реально
автоматическ: автоматический автоматически
подбор: подбор
управля: управляющую управлять
контролируем: контролируемых
банальн: банальностей
фестивал: фестиваль
хайп: хайпа
легк: легко
уста: устать
говор: говорят
зачаст: зачастую
однообразн: однообразно
увол: уволят
дел: деле
никак: никакой
рассужда: рассуждают
дива: дивана
заката: закатав
рукав: рукава
абстрактн: абстрактными
рассужден: рассуждениями
опыт: опытом
провед: провед
выступ: выступят
рассчита: рассчитаны
личн: лично
трет: третьи
смотр: смотрят
ракурс: ракурса
клубничк: клубничка
торт: торте
садоводств: садоводству
дух: духе
источник: источник
примечан: примечание
переводчик: переводчика
сред: среди
культов: культовая
выпущен: выпущенная
языков: языковых
чат: чат
бот: бота
оказа: оказалось
важн: важной
русск: русский
реш: решили
исправ: исправить
найд: найд
выпуст: выпустим
продолжен: продолжение
кратк: краткое
содержан: содержание
распростра: распростран
нны: нные
преобразован: преобразования
рекуррентн: рекуррентных рекуррентности
св: св
рточн: рточных
включа: включают
энкодер: энкодер
декодер: декодер
соединя: соединяются
механизм: механизма механизмах
предлага: предлагают
трансформер: трансформер
исключительн: исключительно
рток: рток
показа: показали
распараллеливан: распараллеливанию
меньш: меньшие
времен: временные
затрат: затраты
достига: достигает
метрик: метрике
английск: английского английском
немецк: немецкий
превосход: превосходит
предыдущ: предыдущий
пункт: пункта
французск: французский
достигл: достигла
наилучш: наилучшего
дне: дней
составля: составляет
вычислительн: вычислительных
мощност: мощностей мощности
затрач: затрачены
имеющ: имеющихся
публикац: публикаций публикации
синтаксическ: синтаксический
разбор: разбор
предложен: предложений
весьм: весьма
определен: определения
поз: поз
макс: максим
ал: ал
шин: шин
познаком: познакомимся
обсуд: обсудим
принцип: принцип
разбер: разбер
мся: мся
принципиальн: принципиально
отлича: отличается
скелет: скелетов скелетами
инференс: инференс
предобучен: предобученной
копан: копания
первоисточник: первоисточниках
уда: удалось
почерпнут: почерпнуть
факт: фактов фактах
читател: читателями
труднопереводим: труднопереводимые
термин: термины
остава: оставаться
объясн: объяснить
физик: физику физики
сгустк: сгустке
шум: шума
капл: капли
черн: чернил
золот: золотой
рыбк: рыбки
популярн: популярное
неограничен: неограниченные
центр: центров
распределен: распределенные
изучен: изученной
информац: информации информация
принима: принимать
интуиц: интуиции
доступн: доступные
революцион: революционные
прида: придали
индустр: индустрии
импульс: импульс
помогл: помогли
методик: методики
микроэлектроник: микроэлектроники
оптическ: оптических
производствен: производственных
разобра: разобраться
пониман: понимания
физическ: физических
закон: законов
теор: теорий
знан: знание
хард: хард
скилл: скилл
останет: останетесь
борт: бортом
динамичн: динамично
тезис: тезис
иллюстрир: иллюстрирует
подготов: подготовили
сюд: сюда
ваканс: вакансий вакансии
аккаунт: аккаунт
войт: войти
регистрац: регистрация
раздел: разделы
хаб: хабы
песочниц: песочница
устройств: устройство
сайт: сайта
документ: документы
соглашен: соглашение
конфиденциальн: конфиденциальность
услуг: услуги
корпоративн: корпоративный
медийн: медийная
реклам: реклама
нативн: нативные
образовательн: образовательные
программ: программы
стартап: стартапам
мегапроект: мегапроекты
дзен: дзен
настройк: настройка
вернут: вернуться
стар: старую
верс: версию
rss: rss
craxti: craxti
gan: gan
nstrek: nstrek
gridsearch: gridsearch
progressivegridsearch: progressivegridsearch
ml: ml
open: open
sourc: source
python: python
alex: alex
g: g
jug: jug
ru: ru
group: group
process: processing
stabl: stable
diffus: diffusion
shwar: shwars
techtrain: techtrain
ai: ai
vova: vova
sam: sam
kera: keras
lstm: lstm
tensorflow: tensorflow
c: c
newtechaudit: newtechaudit
machin: machine
learn: learning
data: data
scientist: scientist
nta: nta
comput: computer
vision: vision
cv: cv
selenzorn: selenzorn
selectel: selectel
big: big
engin: engineering
analyt: analytics
virtual: virtual
davm: davm
vasili: vasily
sizov: sizov
autobinari: autobinary
part: part
alik: alike
luksian: luksian
mine: mining
natur: natural
languag: language
n: n
http: http
abcabd: abcabd
ab: ab
bc: bc
ca: ca
bd: bd
abc: abc
abd: abd
ivankondrakov: ivankondrakov
codeinsideteam: codeinsideteam
yolov: yolov
deepsort: deepsort
deepstream: deepstream
kasperski: kaspersky
lab: lab
chatgpt: chatgpt
lead: lead
incid: incident
respons: response
team: team
stvetro: stvetro
gpt: gpt
tochillin: tochillin
realtim: realtime
catboost: catboost
ddo: ddos
rp: rps
itmo: itmo
numpi: numpy
scipi: scipy
networkx: networkx
github: github
arseicumsesc: arseicumsesc
samsung: samsung
innov: innovation
campu: campus
word: word
excel: excel
anatolybelov: anatolybelov
phillennium: phillennium
spring: spring
midjournei: midjourney
vd: vds
ruvd: ruvds
attent: attention
bleu: bleu
wmt: wmt
gpu: gpu
pose: pose
yolo: yolo
randal: randall
cloudmt: cloudmts
quanta: quanta
magazin: magazine
zlodeiba: zlodeibaal
leono: leono
snaker: snakers
barakadama: barakadama
dvideo: dvideo
alizar: alizar
m: m
rko: rko
mephistophei: mephistopheies
stalkermustang: stalkermustang
sim: sim
nsai: nsays
facebook: facebook
twitter: twitter
vk: vk
telegram: telegram
youtub: youtube
habr: habr
