хабр: хабр
откр: открыть
список: список
стат: стать статей статьи
автор: автором автор авторы авторов
поток: потоки
разработк: разработка
администрирован: администрирование
дизайн: дизайн
менеджмент: менеджмент
маркетинг: маркетинг
научпоп: научпоп
поиск: поиск
профил: профиль
обнов: обновить
карм: карма
рейтинг: рейтинг рейтинге
валер: валерий
линьк: линьков
сетев: сетевой сетевых
администратор: администратор администраторов
публикац: публикации
комментар: комментарии
закладк: закладки
ещ: ещ
подписчик: подписчики
подписк: подписки
значк: значки
захабрен: захабренный
бет: бета
тестер: тестер
техноавтор: техноавтор
приглаш: приглашен
март: марта
приглашен: приглашению
нло: нло
дипломирова: дипломированный
специалист: специалист
международн: международном
соревнован: соревновании
системн: системных
заня: занял
мест: место
мир: миру мир
росс: россии россия
машин: машинном
зрен: зрении
математическ: математической
обработк: обработки
изображен: изображений
официальн: официальный
видеоинженер: видеоинженер
музыкальн: музыкальной
групп: группы
основател: основатель
перв: первой
москв: москве москва
академ: академии
баз: базе
предприят: предприятия
собствен: собственных
методическ: методических
разработок: разработок
техническ: технических техническая
посвящ: посвящ
нных: нных
национальн: национальной
безопасн: безопасности безопасность
контактн: контактная
информац: информация
состо: состоит
хаб: хабах хабы
показа: показать
подписа: подписан
компан: компании компания компаний
крок: крок
ит: ит
разрабатыва: разрабатываем
электроник: электронику
задрот: задротов
карьер: карьера карьеру
помога: помогаем
стро: строить
инфосистем: инфосистемы
джет: джет
российск: российская
лаборатор: лаборатория
касперск: касперского
лов: ловим
вирус: вирусы
исследу: исследуем
угроз: угрозы
спаса: спасаем
старательн: старательного
невозможн: невозможного
сбер: сбер
банк: банк
инфраструктур: инфраструктура
бизнес: бизнеса
ростелек: ростелеком
солар: солар
имен: имени
солнц: солнце
журна: журнал
хакер: хакер
яндекс: яндекс
дела: делаем
й: й
откуд: откуда
московск: московская
обл: обл
дат: дата
рожден: рождения
апрел: апреля
зарегистрирова: зарегистрирован
сентябр: сентября
активн: активность
вчер: вчера
аккаунт: аккаунт
войт: войти
регистрац: регистрация
раздел: разделы
новост: новости
песочниц: песочница
устройств: устройство
сайт: сайта
документ: документы
соглашен: соглашение
конфиденциальн: конфиденциальность
услуг: услуги
корпоративн: корпоративный
блог: блог
медийн: медийная
реклам: реклама
нативн: нативные
проект: проекты
образовательн: образовательные
программ: программы
стартап: стартапам
спецпроект: спецпроекты
дзен: дзен
настройк: настройка
язык: языка
поддержк: поддержка
вернут: вернуться
стар: старую
верс: версию
valerylinkov: valerylinkov
cisco: cisco
netrid: netriders
onairstudio: onairstudio
facebooki: facebooki
sisselogimin: sisselogimine
twitter: twitter
http: https
babaika: babaika
valeri: valeri
linkov: linkov
vk: vk
net: net
c: c
css: css
data: data
engin: engineering
devop: devops
dii: diy
habr: habr
html: html
ipv: ipv
infrastructur: infrastructure
compani: companies
standard: standards
emigr: emigration
java: java
javascript: javascript
open: open
sourc: source
python: python
visual: visual
studio: studio
flipper: flipper
devic: devices
creat: create
servic: services
geek: geeks
product: productivity
selectel: selectel
build: building
internet: internet
facebook: facebook
telegram: telegram
youtub: youtube
