хабр: хабр
откр: открыть впоследствии
список: список
стат: стать разбираем разделы
автор: автором хабы сайта
поток: потоки
разработк: разработка разработку разработки
администрирован: администрирование
дизайн: дизайн
менеджмент: менеджмент
маркетинг: маркетинг
научпоп: научпоп
поиск: поиск
профил: профиль
обнов: обновить
рейтинг: рейтинг
онлайн: онлайн
патент: патент патентов патенты патентах
личн: личный
патентн: патентный патентного патентные патентной патентными патентное
офис: офис
блог: блог
новост: новости
подписчик: подписчики
сотрудник: сотрудники
нов: новые новейшую силу
скопирова: скопировать
ссылк: ссылку
показыва: показывать долларов
лучш: лучшие
примен: применить
час: часов
хранен: хранение
дан: данных данные
днк: днк
помест: поместить
знан: знания
обувн: обувную
коробк: коробку
прочтен: прочтение
мин: мин
количеств: количество количества
просмотр: просмотров
компан: компании компаний компаниям
читальн: читальный
зал: зал
патентован: патентование
конц: конце
прошл: прошлого деятельности
бостонск: бостонскому
стартап: стартапу стартапов программы
уда: удалось
записа: записать
отрывок: отрывок
слов: слов словам товаре прямом
гамлет: гамлета
шекспир: шекспира
искусствен: искусственную искусственный
молекул: молекулу
учен: ученые ученых
произвел: произвели
ключев: ключевым ключевых
заня: заняло
минут: минут
скорост: скорость
выгляд: выглядит
впечатля: впечатляющей
поисковик: поисковики интернет поисковиков
способн: способны
наход: находить
гигабайт: гигабайты
информац: информации краткую сюда
интернет: интернета создания
секунд: секунду
возможн: возможность грамматикам
извлечен: извлечения
зашифрова: зашифрованных
работ: работы работе товаров
шаг: шагом
массов: массовому
распространен: распространению
технолог: технологии технологиями технологий
рассказыва: рассказываем
революцион: революционный
потенциа: потенциал
запис: записи
как: какие стала
проблем: проблемы
возникл: возникли сорока
пут: пути
чита: читать помощи
дал: далее
голос: голосов
добав: добавить
закладк: закладки
комментар: комментарии
апр: апр
судьб: судьба
интеллектуальн: интеллектуальной интеллектуальная интеллектуальный
собствен: собственности собственность
российск: российских российские фз
банкротств: банкротстве
уровен: уровень
сложност: сложности строго
прост: простой
обзор: обзор пишут отраслях
весьм: весьма
цен: ценный цене
акт: актив
помоч: помочь
справ: справиться
сложн: сложной сложно
финансов: финансовой финансовых финансовыми
ситуац: ситуацией
расплат: расплатиться
долг: долгам
нематериальн: нематериальные нематериальных
актив: активы активов
отража: отражаются
баланс: балансе
служ: служить
залог: залогом
банк: банке банк банки банка
реализац: реализация реализацию
вполн: вполне
осуществим: осуществима
анализ: анализ
лит: литий лития
ион: ионных ионного ионные ионы
аккумулятор: аккумуляторов аккумулятора аккумуляторы
росс: россии местоположение
последн: последние последних стране
средн: средний средними
энерг: энергия энергию
элемент: элементы
питан: питания
литиев: литиевый
бум: бум
нача: начавшийся начаться
набира: набирает
оборот: обороты
запас: запасов запасы
никт: никто
знает: знает
оценива: оценивались оцениваются
тон: тонн
миллион: миллион миллиона нагасаки
добыч: добыча
должн: должна заболевания
ближайш: ближайшие
год: годы годов
принят: принята
концепц: концепция
развит: развития развитие
электротранспорт: электротранспорта
залож: заложен
бюджет: бюджет
миллиард: миллиард
рубл: рублей
никак: никак
сыр: сырье
изобретен: изобретения изобретений направлениях
японск: японским японское сыграли окончания
химик: химиком
син: сино
акир: акирой
современ: современного поисковикам
вариант: варианта
удобств: удобству
эксплуатацион: эксплуатационным
характеристик: характеристикам
сфер: сфере сферам сферах ритуализированную
придума: придумано
таков: таковым
относ: относят
номенклатур: номенклатуру
перезаряжа: перезаряжаемых
устройств: устройств песочница
например: например
полимерн: полимерные
кобальтов: кобальтовые
желез: железо
фосфатн: фосфатные
титанатн: титанатные
проч: прочие
использ: использующие используется частично
рубеж: рубежом
сотн: сотни
организац: организаций организациями
запатентова: запатентовали
тысяч: тысячи
сдела: сделано
разбира: разбираемся мире
мар: мар
плазм: плазма
альтернативн: альтернативной
энергетик: энергетике энергетики
эколог: экология
экологичн: экологичных
энергетическ: энергетических
упор: упор
прав: правило правами право прав защищать
дела: делается делают
солнц: солнца
ветр: ветра
времен: временем энтузиастам сдвинуть
правительств: правительства правительство
мног: многих смерть китай
стран: стран страны страна всей
вкладыва: вкладывают
огромн: огромные свойства
сумм: суммы
контролируем: контролируемого
термоядерн: термоядерного
синтез: синтеза
плазмен: плазменной
четв: четв
ртно: ртное
состоян: состояние
веществ: вещества десяти
могл: могла ним
использова: использована использоваться использовать
сам: самых самые жить болезни
разн: разных разные
проект: проектах проекте нативные
воплот: воплотить
недостаточн: недостаточного
нужн: нужных
материал: материалов материале композиционных
открыва: открывают
человечеств: человечеством
перспектив: перспективы
монетизирова: монетизировать
прода: продать
лицензирова: лицензировать
монетизац: монетизация
одн: одна одни одно
цел: целей
регистрац: регистрации войти
мал: малыми
предпринимател: предпринимателями предприниматели ответы
крайн: крайней
мер: мере запретительные
опрос: опрос
европейск: европейского
ведомств: ведомства
показа: показал
получен: получение
приб: прибыли
причин: причина
случа: случаев
ценност: ценность
высок: высока
некотор: некоторым некоторые
подсчет: подсчетам
приход: приходится приходилось
капитализац: капитализации
индекс: индекса
счита: считается
вплот: вплоть
принос: приносят
правообладател: правообладателям
существен: существенной
числ: числе
связыва: связывают
низк: низким
уровн: уровнем
пониман: понимания современном
популярн: популярные популярное игр
способ: способы способ
производств: производстве
продаж: продажа
лицензирован: лицензирование
сравн: сравним
истор: история историю античности
прова: провала
научн: научно
двойн: двойная
бухгалтер: бухгалтерия
позволя: позволяет
публикова: публиковать
отчет: отчетах
цифр: цифры
внутрен: внутренних
процесс: процессов
писа: писать
веден: ведения
уч: уч
возмож: возможен
небольш: небольших
фирм: фирмах
крупн: крупных крупные
предприят: предприятиях заводов
услед: уследить
нюанс: нюансами
большинств: большинстве
незакон: незаконно незаконные
ув: увы
корпорац: корпорации корпораций
избежа: избежали
соблазн: соблазна
определ: определ
нног: нного
момент: момента
удава: удавалось
вод: водить
обществен: общественность будоражат
федеральн: федеральные редакция
власт: власти
нос: нос
взлет: взлете
паден: падении
расскаж: расскажем
наш: нашем нашей
траст: траст
лопнул: лопнул
аналитик: аналитика
недавн: недавнего
извест: известен
поддержк: поддержкой техническая
технологическ: технологических
величин: величине
банкрот: банкрот
сред: среди
американск: американских слова
капитализм: капитализма
март: марте
призна: признан
неплатежеспособн: неплатежеспособным
переда: передан
внешн: внешнее
управлен: управление кафедрой
специализац: специализации
несмотр: несмотря
налич: наличие
общемиров: общемировых
тенденц: тенденций
ин: иных смягчается
определен: определенных
государств: государств
феномен: феномене
поговор: поговорим
оправда: оправдана
критик: критика
адрес: адрес
систем: системы системой
пик: пиком
негодован: негодования
период: период
век: века
великобритан: великобритании
традицион: традиционно
выступа: выступают
групп: группы
лиц: лиц
ожидаем: ожидаемо
сет: сетующие
ограничен: ограничение
свободн: свободной
торговл: торговли
удивительн: удивительно
изобретател: изобретатели
сут: сути
монопол: монополия
станов: становится
хорош: хорошей
почв: почвой
злоупотреблен: злоупотребления
практик: практика
борьб: борьбы
тролл: троллями
доказыва: доказывает
вред: вред
существ: существует
регулир: регулирующей
труд: труд
посмотр: посмотрим
аргумент: аргументы
выдвига: выдвигаются
вс: вс
плох: плохо
краж: кражи
вымогательств: вымогательство
западн: западных
обеспеч: обеспечили
экономическ: экономическое японском назовут
чуд: чудо экономическом экономическим
ретроспектив: ретроспектива
молниеносн: молниеносное
япон: японии упал
миров: мировой мирового
войн: войны
главн: главных главного
чудес: чудес
экономик: экономики японская мощи
пар: пару
десятилет: десятилетий
потеря: потеряла
лежа: лежала
руин: руинах
смогл: смогла
постро: построить
мощн: мощнейшую
точн: точную
промышлен: промышленность
преврат: превратиться
производител: производителя
электроник: электроники
успех: успеха
темн: темная
сторон: сторона
некогд: некогда
нул: нуля
разрабатыва: разрабатывать
поэт: поэтому
добыва: добывать
правд: правдами
неправд: неправдами
покупа: покупать
вымога: вымогать
шантажирова: шантажировать
ворова: воровать
активн: активно
помога: помогало
котор: которое
пор: порой
курирова: курировало
однозначн: однозначно
действ: действия
нарушен: нарушения
помогл: помогли
величайш: величайшее
эпох: эпохи
получ: получили
понят: понятию понятие
финтех: финтеху финтеха
практическ: практически огромный
платежн: платежные
официальн: официально
подразумева: подразумевает
используем: используемые
инновацион: инновационных
так: таких
больш: большие требующим
блокчейн: блокчейн
интеллект: интеллект
центральн: центрального
подробн: подробно подробный
план: план
излож: изложен
соответств: соответствующем выражений
предлага: предлагаем
посмотрет: посмотреть
двумерн: двумерных
част: часть части
втор: вторая
продолжа: продолжаем
разработок: разработок
реч: речь
пойдет: пойдет
основн: основных
отечествен: отечественных
област: области
частност: частности
граф: графен открытия
вакцин: вакцина
спинальн: спинально
мышечн: мышечной мышечная мышечный
атроф: атрофии атрофия
сма: сма
дорог: дорогая самое
организм: организме
генетическ: генетической
мутац: мутации
перест: переста
работа: работать
ген: ген носителями
производя: производящий
белок: белок
недостаток: недостаток
белк: белка
очеред: очередь
привод: приводит
гибел: гибели
моторн: моторных
нейрон: нейронов
нервн: нервных
клеток: клеток
отвеча: отвечающих
движен: движение
мышц: мышц
результат: результате обобщены
скелет: скелет
человек: человека департамента
постепен: постепенно
редуцир: редуцируется
реб: реб
нок: нок
либ: либо
начина: начинает участники
ход: ходить
стад: стадиях
самостоятельн: самостоятельно
дыша: дышать
тип: типа тип
настольк: настолько
тяж: тяж
ло: лое
заболеван: заболевание проявления
дет: дети
жит: могли
распростра: самый
нны: распростран
больн: нный
носител: больных
явля: гена
примерн: является
сорок: примерно
вероятн: возникла
проявлен: вероятность
родител: должны
лечен: родителя
болезн: лечение
мир: дорогое
создан: статье
исполня: понимании
срок: исполняется
историческ: срок
мерк: историческим
микроскопическ: меркам
отнюд: микроскопический
историк: отнюдь
профессионал: историкам
энтузиаст: профессионалам
интервал: временном
тесн: интервале
буквальн: тесно
смысл: буквальном
негд: смысле
повернут: негде
задев: повернуться
друг: задевая друг
стара: друга
сдвинут: стараются
рамк: временные
деятельн: рамки
античн: прошлое
поправк: истории
закон: поправки федерального установленные
государствен: закон иностранных использовании управления проверке
язык: государственном русского
ответ: языке
айтишник: предпринимателей
туториа: айтишников
феврал: туториал
вступ: февраля
сил: вступила
редакц: новая
фз: закона
федерац: российской
пишут: федерации
направл: обзоров
использован: направлен ст
иностра: использования
орган: государственными
фактическ: органами
установлен: фактически
запретительн: законом
шир: меры
определя: шире недвусмысленно определяет нормы
обязательн: определяют
русск: обязательность аналогов этикетке
предназначен: языка
потребител: предназначенной
товар: потребителей информацию
услуг: работ конфиденциальность
совершен: услуг
четк: совершенно
недвусмыслен: четко
корректн: определяться
глас: корректность
п: гласит
ст: п
допуска: государственного
употреблен: допускается
исключен: употребление
перечен: исключением
содерж: перечень
нормативн: содержится определяются утвержденным
словар: нормативных нормативными нормативным
имеют: словарях
общеупотребительн: имеют
аналог: общеупотребительных
выражен: русском
норм: соответствующих каковые
литературн: нормам
каков: литературного
справочник: словарями словарям
грамматик: справочниками справочникам
этикетк: грамматиками
написа: русски
кратк: написали
текст: слово
соответствова: тексте
утвержден: соответствовать
строг: возможно
исполнен: сложность
смягча: исполнения
обстоятельств: иными
попробу: обстоятельствами
разобра: попробуем
детальн: разобраться
цифров: детально
погост: цифровой
совокупн: погост
решен: совокупность
связа: решений
аспект: связанных
человеческ: аспектами
смерт: человеческой сферу
инновац: смерти
захоронен: инновации
усопш: захоронения
оформлен: усопших
завещан: оформления
документ: завещаний авторов
сохранен: документов
памят: сохранением
представ: памяти
ритуализирова: представить
смел: многие
будоражат: смелые
морал: общественную
вызыва: мораль
отторжен: вызывают
направлен: отторжение
индустр: изобретениях игровая
открыт: индустрии пользуясь
двухмерн: графена рф
форм: двухмерной
углерод: формы
обнаруж: углерода
десят: обнаружены
схож: веществ
структур: схожей
гексагональн: структурой
нитрид: гексагональный
бор: нитрид
дихалькогенид: бора
переходн: дихалькогениды
металл: переходных
др: металлов
физик: др
химическ: физико
свойств: химические
частичн: практический
композицион: используются
защитн: материалах
покрыт: защитных
биомедицинск: покрытиях
датчик: биомедицинских
фармацевтик: датчиках
отрасл: фармацевтике
обобщ: обзоре
рид: результаты
рф: рид
пользу: двухмерных
баз: открытыми
фев: базами
появлен: фев
аппарат: появления
ивл: аппаратов
джон: ивл брат
эмерсон: джон
филип: эмерсон
дринкер: филип
сем: дринкер
отец: семьи
профессор: отец
завед: профессором
кафедр: заведующим
здравоохранен: государственной
колумбийск: здравоохранения
университет: колумбийского гарвардском
член: университета
многочислен: членом
комисс: многочисленных
проверк: комиссий
лечебн: государственных
учрежден: лечебных
мест: учреждений
комиссар: местах
нью: комиссаром
йорк: нью
начальник: йорка
городск: начальником
департамент: городского
медицинск: человеком оказания
круг: медицинских
сша: кругах
уважа: сша
влиятельн: уважаемым
старш: влиятельным
брат: старший
исследова: джона
гарвардск: исследовал
физиолог: университете
растен: физиологию
впоследств: растений
хлоропласт: открыл
фотосист: хлоропластах
реакцион: фотосистем
центр: реакционных
фотосинтез: центров
меня: фотосинтеза
востребова: менялось
оказан: востребованных
помощ: медицинской
устро: читайте
компьютерн: устроено
игр: компьютерных продвижение
продвижен: играх
раст: популярность
разработчик: раст
трат: разработчики
средств: тратят
исследован: средств
говор: исследовании колоний
ожида: говорится
рост: ожидается
игров: рост права
рынк: игрового прибыльном
млрд: рынка
доллар: млрд
люб: показывает
прибыльн: любом
треб: рынке
затрат: больших
участник: затрат
защища: начинают
стал: индустрия империи
рол: какую
сыгра: роль чудом
окончан: чуде
прям: экономика
ковров: американские
бомбардировк: ковровые
сравня: бомбардировки
земл: сравняли
завод: землей
все: предприятий
гвозд: последними
забит: гвоздями
гроб: забитыми
могуществен: гроб
импер: могущественной
атомн: стали
бомб: атомные
сброшен: бомбы
хиросим: сброшенные
нагасак: хиросиму
люд: миллионы
оста: людей
кров: остались
прибав: крова
репатриант: прибавились
выдворен: репатриантов
бывш: выдворенных
колон: бывших
производ: говорить
экспорт: производила
упа: экспорт
мощ: япония
капиталистическ: экономикой
удержива: капиталистического
позиц: удерживала
нынешн: позицию
смест: нынешнего
пьедеста: сместил
кита: пьедестала
переня: многое
сосед: перенявший
повержен: соседа
соверш: поверженной
последств: совершить
назовут: последствии
сюд: сыграла
сайт: информация устройство
дат: сайт
июл: дата
числен: июля
местоположен: численность
представител: россия
аккаунт: представитель
войт: аккаунт
раздел: регистрация
хаб: статьи
песочниц: авторы
соглашен: документы
конфиденциальн: соглашение
корпоративн: услуги
медийн: корпоративный
реклам: медийная
нативн: реклама
образовательн: проекты
программ: образовательные
спецпроект: стартапам
яндекс: спецпроекты
дзен: яндекс
настройк: дзен
техническ: настройка
вернут: поддержка
стар: вернуться
верс: старую
rss: rss
gregyku: gregyku
catalog: catalog
technolog: technologies
sokolovp: sokolovps
ko: ko
ya: ya
s: s
p: p
enron: enron
silicon: silicon
vallei: valley
bank: bank
svb: svb
xix: xix
oksana: oksana
nedvigina: nedvigina
smn: smn
i: i
ii: ii
iii: iii
akinshinaa: akinshinaa
deathtech: deathtech
death: death
tech: tech
gan: gan
aln: aln
googl: google
onlinepat: onlinepatent
ru: ru
facebook: facebook
twitter: twitter
vk: vk
telegram: telegram
youtub: youtube
habr: habr
