хабр: хабр
откр: открыть
список: список
стат: стать статьи статье статья статью статей
автор: автором авторы сайта
поток: потоки потока
разработк: разработка разработкой разработки разработке
администрирован: администрирование
дизайн: дизайн дизайна
менеджмент: менеджмент
маркетинг: маркетинг
научпоп: научпоп
поиск: поиск поиска
профил: профиль профиля
обнов: обновить
новост: новости
хаб: хабы
компан: компании компаниях компания авторов
подряд: подряд
скопирова: скопировать
ссылк: ссылку
показыва: показывать
нов: новые новой новый нового
лучш: лучшие
порог: порог
рейтинг: рейтинга рейтинг
уровен: уровень
сложност: сложности
прост: простой
средн: средний
сложн: сложный задача
примен: применить
час: часов
мир: мир миру мире
приключен: приключений приключения
сервер: серверу сервера сервер серверов
част: часть частых
наблюден: наблюдение
кэширован: кэширование
прочтен: прочтение
мин: мин
количеств: количество количества количестве
просмотр: просмотров просмотра
блог: блог
инфраструктур: инфраструктура инфраструктуры инфраструктуру
перевод: перевод
наш: нашей решали
предыдущ: предыдущей
рассмотрел: рассмотрели
интерфейс: интерфейс
хранилищ: хранилища хранилище
исследова: исследовали
единствен: единственную единственная
реализац: реализацию реализация реализацией
дерев: дереве
внимательн: внимательное
сносок: сносок
пост: посте постов
показа: показало показать показала
честн: честными
говор: говоря говорить
оспор: оспорить
техническ: технической технический языка
треб: требуется
базов: базовая базовых
подробн: подробно подробнее
рассмотр: рассмотрим
одн: одном одним одни проблема
будущ: будущих будущее
изуч: изучим
возможн: возможности возможно
чита: читать читайте
дал: далее
голос: голосов
добав: добавить
закладк: закладки
комментар: комментарии комментариях
обзор: обзор
доступн: доступности доступность
сет: сети сетью сетей
сетев: сетевые сетевой сетевое
технолог: технологии технологий технологиям
способн: способность уверены
обеспечива: обеспечивать обеспечивает
пользовател: пользователям пользователей пользователя пользователи пользователями
доступ: доступ
ресурс: ресурсам ресурсов
сервис: сервисам сервисы сервисами транзакциями отдельных
течен: течение
определен: определенного
настоя: настоящее
организац: организации организация помочь
особен: особенности
полност: полностью
завис: зависят
интернет: интернета интернет
прида: придают
больш: большое большого
значен: значение
индикатор: индикаторы
напрям: напрямую
влия: влияют
качеств: качество качестве
обслуживан: обслуживания
производительн: производительность справляться
бизнес: бизнеса бизнес бизнесом бизнесу бизнесы
цел: целом
выход: выход
стро: строя
привест: привести
времен: временной
недоступн: недоступности
потер: потере
дан: данных данное данного данными использует
прерыван: прерыванию
производствен: производственных
процесс: процессов процесс процесса процессы
сокращен: сокращению
доход: доходов
ухудшен: ухудшению
репутац: репутации
поэт: поэтому
жизнен: жизненно жизненного
важн: важно
имел: имела
надежн: надежный упором
механизм: механизм
контрол: контроля
быстр: быстро быстрых быстрые
реагирова: реагировала
возникновен: возникновение
пробл: проблем проблему
применен: применение
аутсорс: аутсорса аутсорс
разн: разных
этап: этапах этап
цикл: цикла
продукт: продукта продуктом продуктов
управлен: управление управления
модел: модели
конференц: конференции
мнен: мнение
появля: появляется
потребн: потребность
команд: команде
встают: встают
конкретн: конкретные
вопрос: вопросы
вс: вс
так: таки такую таких проблемами каково
реш: решить решил
мо: мою
наня: нанять
специалист: специалиста
штат: штат
использова: использовать
аутстафф: аутстафф
отда: отдать
проект: проект проектами проектов нативные
четк: четкие
критер: критерии критерия
выбор: выбора
эффективн: эффективнее эффективные эффективность
рассказыва: рассказываю
основн: основного основные основных
взаимодейств: взаимодействия взаимодействий взаимодействуют
предлага: предлагаю
ваш: вашего
разворачива: разворачиваем
туториа: туториал
достаточн: достаточно
архитектур: архитектуру архитектуры выглядеть
как: каких каким какими какие
компонент: компонентов компонентами
состо: состоит
решен: решение решения
предназнач: предназначено предназначена
развертыван: развертывания
запуск: запуска
кластер: кластером
работ: работу работе работы работа
распределен: распределенное управляем представьте пойдет
приложен: приложение приложения
состоя: состоящим
узл: узлов
истор: истории
хакер: хакеры
удален: удаленно
взламыва: взламывать
умн: умные умный умных умным
гараж: гаражи гаражей
информацион: информационная
безопасн: безопасность безопасности безопасного
облачн: облачные
дом: дом домой доме домов
исследовател: исследователь
обнаруж: обнаружил
ряд: ряд
уязвим: уязвимостей уязвимости
открывател: открывателях
марк: марки
наход: находить
нужн: нужные
люб: любой любые
момент: момент
открыва: открывать
ещ: ещ
привет: привет
матриц: матрица матрицу
зрелост: зрелости
проектирован: проектирование
рефакторинг: рефакторинг
песочниц: песочницы разделы
добр: доброе добро
утр: утро
подним: поднимем
интересн: интересную девайсом
тем: тему теме
современ: современных
реал: реалиях
прийт: прийти
дава: давайте
автоматизиру: автоматизируем
работа: работает работают
крупн: крупных
един: единого
внесен: внесения
изменен: изменений сложная
лес: лес
гриб: грибы
скатерт: скатертью
самобранк: самобранкой
приход: приходить
навязыва: навязывать
ид: идеи
необходим: необходимо необходимостью
выстро: выстроить
состав: составить
набор: набор
требован: требований требования
договор: договориться
участник: участниками участникам
долж: должен
нек: некий
позволя: позволяющий
прозрачн: прозрачный
пут: путь путем
числ: числе
полезн: полезность
автоматизац: автоматизации
использован: использованием использования
понятн: понятных
метрик: метрик
основ: основе
сист: систем
расскаж: расскажу
внедря: внедряли
результат: результатам результатов результате результатом
привел: привело
пройд: пройд
появлен: появления
получен: получения полученном получение
осяза: осязаемых
уч: уч
трудност: трудностей
внедрен: внедрения
побочн: побочных
врод: вроде
старт: старте
вендор: вендорами
окуна: окунайтесь
глубж: глубже
уникальн: уникальные уникальность
индекс: индексы индекса
таблиц: таблиц таблицах
баз: баз базы
распредел: распредел
нны: нные
систем: системы системе системой секунду
аналитик: аналитика
ограничен: ограничения ограниченным
классическ: классическая классический
функц: функция функций
реляцион: реляционной
столбц: столбца столбцов
групп: группы
ввод: ввода
построен: построения
указа: указаны указать
помощ: помощью помощи
ключев: ключевых
слов: слов
сущност: сущности
поддержива: поддерживают поддерживались
разбер: разбер
помога: помогают
принима: принимать
планирован: планированию
пример: примеры
сценар: сценариев
объясн: объясним
обрабатыва: обрабатываются
инструмент: инструменты инструментах
введен: введение
начина: начинающих
ов: ов
зовут: зовут
над: надя
занима: занимаю занимаюсь
должност: должность
специализир: специализируется
мобильн: мобильных мобильными казалось
игр: игр
хоч: хочу
подел: поделиться
информац: информацией песочница
использ: использую используют применимо
рассказа: рассказать
кажд: каждом
апр: апр
дела: делать делают
прототип: прототипы прототипа
печатн: печатных печатной
плат: плат платы платах расходами
проклина: проклинать
вариант: вариант
лайфхак: лайфхаки лайфхаков
программирован: программирование программировании
микроконтроллер: микроконтроллеров
вещ: вещей
сдела: сделай сделать сделал
гик: гиков
инженерн: инженерные
хочет: хочет
отказа: отказаться
отладочн: отладочных
испыта: испытать
отладк: отладке
собствен: собственной собственный
мотив: мотивы
размер: размеры
устройств: устройств информация
эстетическ: эстетический
вид: вид виды
пар: пару
схем: схем
знаком: знакомимся
машин: машинное
обучен: обучение
учебн: учебный
искусствен: искусственный искусственного
интеллект: интеллект интеллекта
языков: языковой
представл: представлена
встро: встроен
мног: многие многих
программист: программисты
документац: документации
веден: ведения
панельн: панельном панельных
замен: заменить замене заменой
стар: старый старого старой старую
конвектор: конвектор
радиатор: радиатор радиатора
пожалет: пожалеть
научн: научно
популярн: популярное популярный
иде: идея
сантехническ: сантехническим
уклон: уклоном
возникл: возникла возникли
ютуб: ютубе
видеоролик: видеоролика видеоролику
монтаж: монтаже
секцион: секционного
биметаллическ: биметаллического биметаллический
отопительн: отопительного
прибор: прибора
тип: типа
гармошк: гармошка гармошку
однотрубн: однотрубной
отоплен: отопления
котор: которую которое которым
советск: советских
врем: врем
н: н
применя: применяют применяем
подавля: подавляющем
видосик: видосике
сошл: сошлись
смертельн: смертельной
схватк: схватке
блогер: блогера
сантехник: сантехника
счита: считал
прав: прав
батал: баталии
альтернативн: альтернативные
совпада: совпадающие
дуэлянт: дуэлянтов
сво: сво своими
виден: видение
описа: описал
ответ: ответа ответов ответ
получ: получил получим
итог: итоге
написа: написать
прояснен: прояснения
сут: сути
проблем: проблемы различными железом
широк: широкой
масс: массе
жител: жителей
особ: особый
интерес: интерес
возник: возник
личн: лично
собра: собрался
поменя: поменять
облезл: облезлую
см: см
рис: рис
бел: белый
красив: красивы
пожалова: пожаловать
карьер: карьера
индустр: индустрии
нескольк: нескольких
значительн: значительная
итогов: итогового
осуществля: осуществляется
представля: представляет
отправн: отправную
точк: точку
созда: создал
существован: существования
расшир: расширен
поддержан: поддержания
дополнительн: дополнительной связан
произвольн: произвольной
функциональн: функциональности
оказыва: оказывается
мест: местом
изначальн: изначально
задума: задумано
размещен: размещения
крайн: крайней
мер: мере мер
хорош: хорошего
сер: серии
погруз: погрузимся
дета: детали
представлен: представление
параллельн: параллельно
поэкспериментиру: поэкспериментируем
пользовательск: пользовательских пользовательскими
создад: создадим
инструментар: инструментарий
модифицирова: модифицировали
соответств: соответствии должна
кейс: кейсами микросервисы
знает: знает
постро: построим
типичн: типичных типичные
ошибок: ошибок
исправ: исправить
персонал: персоналом
явля: является
социальн: социальных
ит: ит
отрасл: отрасли
имеет: имеет
ежемесячн: ежемесячно
ктивн: ктивными
росс: россии
отклика: откликаются
ваканс: вакансии
получа: получают
подход: подходы подхода подход
увелич: увеличить
запрос: запросы максимального
например: например
прям: прямое
общен: общение общения
работодател: работодателями
верн: верного
результативн: результативного
подготовительн: подготовительных
действ: действий
перв: первое
обновлен: обновление
исправлен: исправление исправления
ошибк: ошибки произошла
встреча: встречаются
негативн: негативно
повлия: повлиять
уменьш: уменьшить
шанс: шансы
отклик: откликов
сто: стоит
повторя: повторять
соверша: совершают
создан: создании
поясня: поясняем
повыс: повысить
счет: счет
москвич: москвич
крок: крок
тестирован: тестирование
хранен: хранение
компьютерн: компьютерное
желез: железо флагманским
дел: делимся
тест: тестами тесты
ситоник: ситоника
выступа: выступать
виртуализац: виртуализации саг
поставля: поставляет
российск: российская
практик: практика практике
хвата: хватает
большинств: большинства
типов: типовых
задач: задач состоянием перезапустился
отлича: отличается
наводн: наводнивших
последн: последнее
отечествен: отечественный
рынок: рынок
китайск: китайских
равн: равно
пришл: пришлось
выясня: выяснять
нюанс: нюансы копейки
кат: катом
баг: багов
бог: богу
плюс: плюсы
минус: минусы
имплементац: имплементации
лаборатор: лаборатория лаборатории
касперск: касперского
дефолт: дефолту
разработчик: разработчики
стрем: стремясь
достич: достичь
идут: идут
операцион: операционным
пишут: пишут
рев: ревью
устраня: устранять
факт: факту
выявлен: выявления
существ: существует существуют
рамк: рамках
комплекс: комплекс
станов: становится
нуж: нужен
неявн: неявно
выполн: выполнены либо
правильн: правильного правильно
серг: сергей
талант: талантов
архитектор: архитектор
предъявля: предъявляются
сам: самые самый знают
жестк: жесткие
план: плане
теор: теории
паттерн: паттерны
продолжа: продолжать продолжают
развива: развивать
измен: изменилось
феврал: февраля
олег: олега
бунин: бунина
онтик: онтико
оборудован: оборудование
коротк: короткий
люд: людей
пользова: пользоваться
доставк: доставкой
ед: еды
кида: кидать
заказ: заказы
корзин: корзины
маркетплейс: маркетплейсов
растут: растут
поддержк: поддержкой техническая
развит: развитием
справля: справляемся способны
потребова: потребовало
адаптац: адаптаций
кирилл: кирилл
малеван: малеванов
директор: директор
начал: начале
столкнул: столкнулись
строительств: строительство
дат: дата
центр: центра
закупа: закупать
лиша: лишать
клиент: клиентов
технологическ: технологических
новинок: новинок
выгляд: выглядит корпус
провайдер: провайдеров
разрез: разрезе
умеет: умеет
виде: видео
доклад: доклада докладе доклад
флант: флант
системн: системное
препарир: препарирую
даб: дабы
поня: понять
подводн: подводные
камн: камни
ждат: ждать
рекоменд: рекомендую
ознаком: ознакомиться
прощ: ним
выз: проще
асинхрон: вызов
внешн: асинхронных внешних случаях интегрируясь
помоч: внешние
оптимизирова: организациям
операц: оптимизировать
сниз: операции
затрат: снизить
улучш: затраты
услуг: улучшить конфиденциальность
интеграц: услуг
сторон: интеграции
мож: сторонними
столкнут: можем
различн: столкнуться
отказоустойчив: такими
стоимост: отказоустойчивость
должн: стоимость система
увер: должны
просто: производительности
некотор: простоев
случа: некоторых
связа: внешнего
расход: дополнительными
лиценз: плата
поставщик: лицензию
заключ: поставщиком
контракт: заключен
соблюден: контракт
максимальн: соблюдении
секунд: запросов
образ: соответствующим
адаптирова: образом
покаж: адаптироваться
выглядет: покажем
вызов: архитектура подразумевает
упор: вызова
применим: надежность
интегриру: данные
включа: внешними управлять
электрон: включают
коммерц: электронной
магазин: коммерции
интегрир: магазинов
платежн: интегрирующихся
шлюз: платежными
логистическ: шлюзами
сектор: логистические
здравоохранен: секторах
банковск: здравоохранения
сфер: банковской
управля: сферы научились
транзакц: распределенными детерминированно распределенных
саг: сервисах
микросервис: виртуализация
ил: кейс
казначе: илья
техлид: казначеев
представьт: техлид
сотн: распределенный
шаг: сотни последовательно
выполня: шагов
последовательн: выполняется
подразумева: шаг
отдельн: вызовов
состоян: сервисов изменение
происход: состояния
детерминирова: происходило
либ: транзакция
заверш: выполнилась
откат: завершился
произошл: откатился
главн: ошибка
пошел: главное
перезапуст: пошел
реша: задачу
науч: наших
дюжин: включающими
сраз: дюжину
скаж: сразу
реч: скажу
пойдет: речь
уровн: транзакциях
логик: уровня
смартфон: логики гаджеты полноценными
раскладушк: смартфон смартфонами
двум: раскладушка
диспле: двумя изготовления
ремонтиру: дисплеями
смотр: ремонтируем
редчайшн: смотрим
гаджет: редчайшний
ретроспектив: смартфоны
каза: ретроспектива
заполон: мобильный
одинаков: заполонили практически
меня: одинаковые
изготовлен: меняются
разрешен: дисплеев
корпус: разрешение
практическ: выглядят
немног: одинаково
знают: немногие
сочн: самых
необычн: сочных
выпуска: необычных
азиатск: выпускаются
рынк: азиатского
встрет: рынка
ход: встретишь
всер: ходят
з: всерь
полноцен: з
полноразмерн: раскладушками
флагманск: полноразмерными
рф: одна
доста: рф
аппарат: достать
тяжел: аппараты
уда: тяжело
раздоб: удалось
копейк: раздобыть
требова: нюансом
перепая: требовал
аккумулятор: перепаяем
портиру: аккумулятор
кастомн: портируем
рекавер: кастомное
вычист: рекавери
хлам: вычистим
прошивк: хлам
оцен: прошивки
каков: оценим
девайс: таким
жду: интересно
сюд: жду
аккаунт: сюда
войт: аккаунт
регистрац: войти
раздел: регистрация
сайт: устройство
документ: компаний
соглашен: документы
конфиденциальн: соглашение
корпоративн: услуги
медийн: корпоративный
реклам: медийная
нативн: реклама
образовательн: проекты
программ: образовательные
стартап: программы
спецпроект: стартапам
яндекс: спецпроекты
дзен: яндекс
настройк: дзен
язык: настройка
вернут: поддержка
верс: вернуться
rss: rss
anna: anna
sokol: sokol
api: api
kubernet: kubernetes
southbridg: southbridge
devop: devops
etcd: etcd
cacher: cacher
maxrokatanski: maxrokatansky
otu: otus
sta: stas
tibekin: tibekin
nixi: nixys
conf: conf
andrei: andrey
biryukov: biryukov
apach: apache
kafka: kafka
zookeep: zookeeper
kraft: kraft
zookep: zookeper
virtual: virtual
explor: explorer
firstvd: firstvds
nexx: nexx
darkbenladan: darkbenladan
govern: governance
enterpris: enterprise
agil: agile
recoveri: recovery
mode: mode
edeshina: edeshina
greenplum: greenplum
ao: ao
postgresql: postgresql
uniqu: unique
primari: primary
kei: key
heap: heap
append: append
optim: optimized
nadejda: nadejda
cherneva: cherneva
data: data
engin: engineering engineer
python: python
mine: mining
big: big
dkosr: dkosr
dii: diy
arduino: arduino
nucleo: nucleo
discoveri: discovery
open: open
js: js
notion: notion
ai: ai
imonin: imonin
s: s
asa: asa
techrecruit: techrecruiter
linkedin: linkedin
remot: remote
inmail: inmails
natesergei: natesergey
sitonica: sitonica
sr: sr
w: w
u: u
wechat: wechat
gmc: gmc
secur: secure security
design: design
c: c
champion: champion
kasperskyo: kasperskyos
cmhungri: cmhungry
selectel: selectel
driusha: driusha
istio: istio
servic: service services
mesh: mesh
kuber: kuber
artfultom: artfultom
aw: aws
step: step
function: functions
amazon: amazon
web: web
serverless: serverless
rp: rps
cloudmt: cloudmts
containerum: containerum
bodyawm: bodyawm
android: android
amol: amoled
samsung: samsung
sm: sm
timeweb: timeweb
cloud: cloud
nix: nix
galaxi: galaxy
facebook: facebook
twitter: twitter
vk: vk
telegram: telegram
youtub: youtube
habr: habr
