хабр: хабр безрадостно известным
откр: открыть челнах исполнилось
список: список
стат: стать статьи статье индустрии курсов
автор: автором авторы вклад
поток: потоки
разработк: разработка управление компаний заказать менеджером
администрирован: администрирование
дизайн: дизайн
менеджмент: менеджмент
маркетинг: маркетинг
научпоп: научпоп
поиск: поиск бот
профил: профиль
обнов: обновить
рейтинг: рейтинг рейтинга
развит: развитие историю
стартап: стартапа стартапов стартапами сфере оригинальном
главн: главное мир айпады
размер: размер разными
умен: умение
развива: развивать
компан: компании аутсорс лица культурой
подряд: подряд
скопирова: скопировать
ссылк: ссылку
показыва: показывать
нов: новые нового новых дающие
лучш: лучшие авторов
порог: порог
уровен: уровень
сложност: сложности техническими
прост: простой простая простое
средн: средний
сложн: сложный сложного самое
примен: применить
минут: минут
лабораторн: лабораторный лабораторное
таймер: таймер таймера
импортозамещен: импортозамещение
подручн: подручных
материал: материалов
прочтен: прочтение
мин: мин
количеств: количество
просмотр: просмотров
программирован: программирование языку обучения
микроконтроллер: микроконтроллеров
нанотехнолог: нанотехнологии
понадоб: понадобился
программируем: программируемый
рел: реле
штуковин: штуковина
указа: указанное
замыка: замыкает
контакт: контакты зрительный
одн: одним размеру общении
слов: словом
начал: началом америке
санкц: санкций
оборудован: оборудование
куп: купить
стал: стало взлетели меняет
невозможн: невозможно
хорош: хороший твиттера
пример: пример
отличн: отличное
устройств: устройство создания
прям: прямо
пишет: пишет
продавец: продавец
случа: случай
удобн: удобная
привлекательн: привлекательная
предыдущ: предыдущий
вариант: вариант
налич: наличии
сто: стоит помещений
непотребн: непотребно
задач: задачи ясно
достаточн: достаточно
обычн: обычного
совмеща: совмещает
нездоров: нездоровую нездоровые
цен: цену
срок: сроки
поставк: поставки
чита: читать
дал: далее службе
голос: голосов
добав: добавить
закладк: закладки
комментар: комментарии публикацию
новост: новости главной
час: часов вентиляции
тестиру: тестируем
формат: форматы форматов форматах крупный
поддержк: поддержки языка
татарстан: татарстане
блог: блог
команд: команда произошло масштабирования
цифров: цифровой
трансформац: трансформации
татарста: татарстана
венчурн: венчурные крупными
инвестиц: инвестиции
ретроспектив: ретроспектива
работ: работа формат начать реализовал
активн: активно вести
ведет: ведется
момент: момента управления
открыт: открытия
казан: казани
перв: первого сожалению
ит: ит
парк: парка парк кстати
запуск: запуском отзывов
башир: башира
рамеев: рамеева
полгод: полгода
продолж: продолжилось
тестирован: тестирование
рассказыва: рассказываем
сво: своем привлечь договоры приносили
опыт: опыте такого
тестирова: тестировал
различ: различия
рабоч: рабочих бонус
процесс: процессов некоторые выстроить сложное
взаимодейству: ним
бизнес: взаимодействуем управляет конструктор интересного
инкубатор: бизнес
крупн: инкубатор управляющих
запущен: работы
стен: запущенный
площад: стенах
тыс: площади
кв: тыс
кстат: кв
набережн: парке
челн: набережных
сраз: открылся
универсальн: сразу
площадк: универсальная
предпринимател: площадка
сфер: предпринимателей
предоставля: стартапам
комплекс: предоставляется
услуг: комплекс конфиденциальность
ресурс: услуг
мест: ресурсов особенное многих
бухгалтерск: мест
обслуживан: бухгалтерского
позволя: обслуживания культуры
нача: позволяющих
проект: работу разработке найме конверсией запуска нативные
меньш: проектом
затрат: меньшими
блогер: затратами
станов: блогеры ежегодно
популярн: становились набирал реально
благодар: популярными
дневничк: благодаря
жж: дневничкам
набира: жж
айфон: популярность
смартфон: айфоны
сенсорн: смартфоны
экран: сенсорными
начина: экранами путь
захватыва: начинали
мир: захватывать
цифровизац: новостью
государствен: цифровизации
управлен: государственного часть сфокусироваться
депутат: момент
госдум: депутатам
разда: госдумы
айпад: раздали
кринж: главным
заседан: кринжем
руб: заседаниях
игр: рубились игр электроники
реальн: игра
мар: популярной
тиндер: мар
теннисист: тиндер
кейс: теннисистов
сдела: кейс потратил
телегр: сделали
бот: телеграм нашего
спарринг: поиска
партн: спарринг
ров: партн
больш: ров идей
теннис: большому
никак: теннису напоминаешь
секс: никакого миллиарды
миллиард: секса
любв: сексе
правильн: любви
знаком: правильно
дела: знакомиться создали
дейтинг: делать
сервис: дейтинг свой подходе
монетизац: сервисы
мобильн: монетизация разрабатываем подрядчиков
приложен: мобильных дайджест продукты
модел: приложений использует
интерв: модели
бывш: интервью
директор: бывший
продукт: директор разработкой абсурдные уйму промышленного
дел: продукту банковское
зарабатыва: делится
правд: зарабатывает доля
пар: правда
подбира: пару
и: подбирает
привлеч: ии
онлайн: сервис
знакомств: онлайн рекомендации
бонус: знакомств
рекомендац: рабочие
парн: знакомству
девушек: парней
истор: девушек рассказали
потрат: истории подписки
переводчик: сделать
част: переводчик
недел: продуктом течение гонки причин
исполн: неделю
фирм: открыл венчурными
занима: фирму криптовалюты
машин: заниматься
перевод: машинным прототип мнение
мног: переводом стоят
произошл: многое
сервер: команде
миллион: серверов создателям
пользовател: миллиона упростить
помн: пользователей
врем: помню
дво: времена
сидел: двое
маленьк: сидели
комнат: маленькой
вентиляц: комнате
открыва: час мультикультурной
окн: открывать
задохнут: окна
полн: задохнуться уроки
надежд: полны
ид: надежд проработка придумал
желан: большого
созда: желания некоторое
сможет: создать
конкурирова: сможет
прототип: конкурировать
собра: переводил
уда: собрать
оказа: удалось советы
клиент: оказалось своими потенциальных
хотел: клиенты
установк: хотели
ос: установку
действова: ос
пришл: действовать
перекомпилирова: пришлось
библиотек: перекомпилировать
куч: библиотек
зависим: кучей
так: зависимостей доски
пош: опыта
л: пош
сайт: л веб чат
фриланс: сайты
размест: фриланса
объявлен: разместил
откликнул: объявлений
нескольк: откликнулось
заявок: нескольких
ясн: заявок
интернет: задача локализация
предложен: интернете
аутсорс: предложений
люб: проектов программирования
образован: любой
инженер: образованию
программист: инженер
заявлен: программист
вызыва: заявление повседневной
удивлен: вызывало
интерес: удивление
реш: интерес ответить приветствую
попробова: решено
сторон: попробовать
вс: стороны
выглядел: вс фоне
сер: выглядело решили
зно: серь
общен: зно нуждаются
вел: общение
имен: велось вещи
юридическ: имени
лиц: юридического
хочет: компания
заказа: хочет
треб: разработку
получ: требуется недели делаем
оценк: получить
реша: оценку
отмет: решаться
котор: отметить
разн: которыми русскоговорящих людей
известн: одна знаменитости васильевым
бренд: известный
лидер: бренд
восточн: лидер
европ: восточной
написа: европе развлекал
менеджер: написал работаю отношениями
продаж: менеджеру
обеща: продажам
связа: обещали свяжутся
течен: связаться
ответ: получил ответа регату
точн: ответили
свяжут: точно
ладн: связались
перспективн: ладно
российск: перспективных настоящее
феврал: российских
облачн: февраль
дайджест: облачные февральском
вест: приложение
образ: активный
жизн: образ
просижива: жизни
штан: просиживать
комп: штаны
генерац: компом
картинок: генерации
русск: картинок
язык: русском статей настройка
заточен: языке
задолба: заточенный
подписыва: задолбался
договор: подписывать
бумаг: клиентами
интересн: бумаге сообщали
февральск: интересных
абсурдн: дайджесте
неожида: приложения информацию
взлетел: неожиданно
культов: стали
обзор: культовыми
убог: обзор
реализац: убогая техническую
вол: реализация
случ: воля
похорон: случая
уйм: похоронила
технологическ: продуктов
решен: технологических принял
обратн: решений
ситуац: обратные менять
бесполезн: ситуации
упорот: бесполезные
взгляд: упоротые
принос: взгляд
создател: своим бизнеса
покоря: миллионы
сердечк: покоряли
вспомина: сердечки
сам: вспоминаем копирайт уголков
ярк: самые
разбира: яркие подробно
культур: разбираем корпоративной внутренней сектора
основ: культура контента
масштабирован: основа
х: команды
ошибк: х привело справиться
найм: ошибки роста
персонал: проектами
карьер: персоналом
индустр: карьера
доработа: статья
верс: доработанная старую
мо: версия
выступлен: моего
настоя: выступления камнями
некотор: настоящий мобильные
ценност: процессы
измен: ценности яхтинг
конц: изменились
полезн: конце
источник: полезных
тем: источников
корпоративн: теме услуги
сожален: компаниях
публикац: первую дело краха
вытащ: комментариями
приня: вытащить шь планирует
опубликова: решение
занов: опубликовать
работа: заново агентству каналов
участв: разработки
последн: участвую
удваива: последние
ежегодн: удваивается
мультикультурн: становится
офис: открываются
америк: офисы
стад: начале
быстр: стадии
рост: быстрого
онбординг: найма
готов: онбординга
привел: готовы
уход: ошибкам
трет: уходу
сотрудник: трети
сильн: сотрудников
демотивац: сильной
гроз: демотивации
потер: грозило
наш: потерей создавали удалил помогал
внутрен: нашей
раст: позволяло
кардинальн: расти
меня: кардинально управлять
расскаж: ситуацию
исследован: расскажу
успешн: исследование
помогл: успешных риелторский
сфокусирова: помогло
справ: управлении
выстро: ошибками
росл: процесс
текучк: росла
поднима: текучки
выш: поднимался
кремниев: выше
долин: кремниевой
читальн: долине
зал: читальный
мнен: зал
накоп: перевод
комнатн: накопить
квартир: комнатную включая
вста: квартиру
шь: вста
наканун: приняв
снотворн: накануне
заснут: снотворное
пятниц: заснуть
вчерашн: пятница
вечер: вчерашний приветствуются
розвуд: вечер
насыщен: розвуде
съезд: насыщенным
мадер: съездить
посмотрет: мадеру
дол: посмотреть
давн: правды
слух: давних
разочарова: слухах
крайн: разочарован
мер: крайней
увидел: мере
бар: увидел
управля: баре обороты привык
замет: фирмами
установ: заметили
зрительн: установить
стоп: контакт
напомина: стоп
знаменит: никакие
радиус: известны
мил: радиусе
сред: миль
читател: среди
текст: читателей
выходн: текст
нейминг: выходной
важн: нейминг
негативн: важно
оп: негативный
выбор: опыт
назван: выбора
локализац: названия
брендинг: интернет
копирайт: брендинг
написан: процессе
код: написание
построен: кода
архитектур: построение
проработк: архитектуры
требован: идеи
обсуд: требований
обед: обсудили
встреча: обедом
кажд: встречается
перечислен: каждом
шаг: перечисленных
повседневн: шагов
трудност: вызывает
дава: трудности саша нашу
называ: давайте
вещ: называть продвинутых
ах: именами
английск: ах
манер: английский
выйт: манер
операционк: выйти
увелич: операционки
выручк: увеличить
аутсорсер: выручку
александр: аутсорсера
карабас: александр
яхтинг: карабасов
отток: изменил
росс: отток продукта
набра: россии
рекордн: набрал
оборот: рекордные
расстоян: бизнесом
разрабатыва: расстоянии нотиссимус
зарубежн: разрабатывает
рынк: зарубежного
ищет: рынка
точк: ищет
соприкосновен: точки
уеха: соприкосновения разлетевшиеся
разлетевш: уехал
атлантическ: уехавшие
океа: атлантический
нужда: океан
единомышленник: одном
рубеж: единомышленниками
существ: рубежом
особен: существует
встреч: место
живет: встречи
оста: живет
стран: остался
регат: стране ездят капитанами пяти
путешеств: регата
яхт: путешествие капитана увлекся
парусн: яхтах
гонк: парусные
делов: неделя
программ: деловой
русскоговоря: программы
уголк: разных
задава: самых
вопрос: задаваемых
слыш: вопросов
организатор: слышим
планир: организаторы
участ: принять
скаж: участие
как: скажите напишу сайта
езд: какие
участник: серию
капитан: участниками
сегодняшн: регаты
гост: сегодняшний
трекер: гость
фри: трекер
контур: фрии
побыва: контур
пят: побывал
шест: регатах
прошел: шести
пут: прошел
яхтсм: начинающего
капита: яхтсмена
смен: яхты
жительств: сменил
екатеринбург: жительства
антал: екатеринбурга
поговор: анталию встретить систему
руковод: поговорили
привык: руководить
эмигрант: стала
практическ: эмигрантов
единствен: практически
способ: единственным
встрет: способом
душ: поговорить
саш: душам
начн: давай
общ: начнем
увлек: общего
топ: яхтами
минус: топ
конструктор: минус
бесплатн: создателей давать абсолютно нечего
самозанят: бесплатная
здравств: самозанятых
связ: здравствуйте
макс: связи
кульгин: максим
учредител: кульгин
нотиссимус: учредитель
дад: получилось
совет: дадим
рол: оказаться
заказчик: роли
подрядчик: заказчиков
доб: мобильной
конверс: добились сработал
реклам: конверсии медийная песочницы
яндекс: рекламы
директ: яндекс
узк: директ
сегмент: узком
медийн: сегменте
контекстн: реклама
повышен: контекстная
песочниц: повышение хабы
узкоспециализирова: рекламу
промышлен: узкоспециализированного
десятк: россию
потенциальн: десятки
неочевидн: клиентов
кана: неочевидный программированию
сработа: канал
расширен: проект
выраст: расширения
аудитор: вырастил
науч: аудиторию
браузер: научился
криптовалют: браузеров
блокчейн: занимаюсь
хоч: блокчейн
запуст: хочу
январ: запустить
использова: январе
платформ: использовал
аналитик: платформу
придума: аналитики
упрост: идею
итог: пользователю
реализова: итоге
месяц: работая
фулл: месяц
тайм: фулл
твиттер: тайм
отзыв: хороших
небольш: проекта
подел: небольшого
напиш: поделиться
техническ: какими соло рассказать отвечающими
сталкива: сложностями
продвига: сталкивался
соцсет: продвигал
достигнут: соцсетях
результат: достигнутые
добр: результаты
пожалова: добро
кат: пожаловать
вмест: кат
подписк: вместо
млн: потратили
кастомн: млн
риэлтор: кастомной
нужн: риэлторов
помим: нужна
базов: помимо
функц: базовых
умел: функций
автоматическ: умела
выкладыва: автоматически
контент: выкладывать работает медиа
доск: контент
нул: такую
окуп: нуля
завершен: окупили
зовут: завершения
вячесла: зовут
люкшин: вячеслав
совладелец: люкшин
агентств: совладелец помогла
недвижим: агентства
собствен: недвижимости сути
заточ: собственную
риелторск: заточена
примерн: работать
раз: примерно
эффективн: раза
сут: эффективнее
систем: собственно
отношен: система
канал: менеджер
классифайд: контентом
создава: классифайдах
клиентск: бесплатное
стартаперск: клиентский
задав: стартаперская
банковск: задавили прич расслабленной
финанс: публикаций
событ: финансы
затм: события
новостн: затмили
повод: новостные
выход: поводы
фон: выход
безрадостн: выглядел
писа: хабре
причин: писали объяснения
последств: причинах
крах: последствиях
подробн: публикации
закат: разбирающие
финансов: закат
светоч: финансового
стартапер: светоча
дающ: стартаперов
информац: новую песочница
прич: неожиданные
специфик: банковской
сообща: специфики
банк: бизнесе
подход: банка
буквальн: сервису
облизыван: буквальным
ног: облизыванием
голов: ног
чересчур: головы
расслаблен: чересчур
сектор: банковского
удал: культуре
объяснен: бота
коллег: недель
помога: коллегой
чат: наших устроен
развлека: чатах
потряса: написан
фреймворк: потрясающем
использ: фреймворке модель
оригинальн: используется
сол: стартап
веб: техническая
рассказа: сайтов саврадым
устро: технически
компонент: каких
состо: компонентов
подводн: состоит
камн: подводными
разработа: российский
аромадиффузор: разработал удивить
ароматизац: аромадиффузор вещах
фильм: ароматизации
производств: фильмов
электроник: производство
игров: игры
консол: игровые
современ: консоли
человек: современного
удив: человека
помещен: аромадиффузорами
включ: местах
торгов: квартиры
центр: торговые
магазин: центры
вручн: магазины
настраив: вручную
частот: настраивая
распылен: частоту
например: распыления
домашн: например
сист: домашнюю
продвинут: поговорим
научн: ароматизация
изучен: научном описать
реакц: изучению
люд: реакции
аромат: разные
использован: ароматы
дан: использование
цел: данных
информацион: целей
служб: информационной
разработчик: дал
област: разработчик
нейросенсорн: области
технолог: нейросенсорных
основател: технологий
букреев: основателем
никит: букреевым
двум: никитой
специалист: двумя
отвеча: специалистами
антон: реализацию
васильев: антоном
воссоздан: хабру
ретроигр: воссоздание
позвон: ретроигры
куз: позвоните
денис: кузе
саврад: денисом
создан: развития
мед: устройства
господ: основы
приветств: господа пожеланиями
описа: решил
абсолютн: изучения
курс: бесплатных пробный
одобрен: любые
осужден: одобрениями
пожелан: осуждениями
неч: вечером
пробн: бесплатный
практикум: курс
подтолкнул: практикуме
зафиксирова: подтолкнул
получен: зафиксировать
знан: полученные
род: знания
иде: родилась
калькулятор: идея
лазерн: калькулятора
резк: лазерной
клр: резки
аплодисмент: клр
студ: аплодисменты
виде: студию
ютуб: видео
уч: ютубе
урок: учим
обучен: полный
прида: канала
уверен: придало
сюд: уверенность
вклад: сюда
аккаунт: лучших
войт: аккаунт
регистрац: войти
раздел: регистрация
хаб: разделы
документ: информация
соглашен: документы
конфиденциальн: соглашение
нативн: корпоративный
образовательн: проекты
мегапроект: образовательные
дзен: мегапроекты
настройк: дзен
вернут: поддержка
стар: вернуться
rss: rss
aleaksah: aleaksah
assembl: assembler
http: http https
www: www
optimum: optimum
lab: lab
ru: ru
product: product
tajmer: tajmer
laboratornyj: laboratornyj
chipdip: chipdip
n: n
ac: ac
dc: dc
digitaltatarstan: digitaltatarstan
twitter: twitter
angri: angry
bird: birds
amedomari: amedomary
tw: tw
face: face
mamba: mamba
aliaksei: aliaksei
rudak: rudak
growth: growth
hack: hacking
googl: google
linux: linux
io: ios
window: windows
saa: saas
s: s
alekseipodkletnov: alekseipodkletnov
zlt: zlt
cultur: culture
fit: fit
saint: saint
teamlead: teamlead
conf: conf
miro: miro
recoveri: recovery
x: x
honyaki: honyaki
skillfactori: skillfactory
techcrunch: techcrunch
kseniamoroz: kseniamoroz
moroz: moroz
team: team
gerasimovich: gerasimovich
peopl: people
founder: founder
softmedialab: softmedialab
makasin: makasin
ik: ik
offlinecrm: offlinecrm
crm: crm
vegner: vegner
b: b
root: root
pet: pet
chrome: chrome
dune: dune
react: react
typescript: typescript
slava: slava
lyukshin: lyukshin
pipedr: pipedrive
moscow: moscow
hous: house
markati: markaty
silicon: silicon
vallei: valley
bank: bank
gpt: gpt
svb: svb
maxpain: maxpain
telegram: telegram
chatgpt: chatgpt
api: api
cloud: cloud
platform: platform
natur: natural
languag: language
process: processing
proxi: proxy
grammi: grammy
open: open
ai: ai
turbo: turbo
rostislavdugin: rostislavdugin
javascript: javascript
node: node
js: js
ancotir: ancotir
d: d
sensorylab: sensorylab
iot: iot
barsik: barsik
kolchasik: kolchasik
python: python
hub: hub
studio: studio
semen: semen
grinshtein: grinshtein
gornal: gornal
progchip: progchip
shurik: shurik
arttom: arttom
alexlash: alexlash
vasyutka: vasyutka
ut: ut
ud: ud
alconost: alconost
facebook: facebook
vk: vk
youtub: youtube
habr: habr
