хабр: хабр
откр: открыть
список: список
стат: стать статьи статья статье статью
автор: автором авторы авторов
поток: потоки
разработк: разработка разработке
администрирован: администрирование
дизайн: дизайн
менеджмент: менеджмент
маркетинг: маркетинг маркетингу
научпоп: научпоп
поиск: поиск поиска
профил: профиль профиля
обнов: обновить
рейтинг: рейтинг рейтинга
больш: большие большим большого больших
дан: данные данных данными дано данной
вс: вс
компан: компании компаний
подряд: подряд
скопирова: скопировать
ссылк: ссылку
показыва: показывать
нов: новые новую нового
лучш: лучшие лучшее лучших
порог: порог
уровен: уровень
сложност: сложности
прост: простой простого
средн: средний
сложн: сложный сложных сложно
примен: применить
час: часов часы
работа: работают работает работать работаю
игров: игровые
механик: механики
прочтен: прочтение
мин: мин
количеств: количество количеством количества
просмотр: просмотров
блог: блог
альф: альфа альфы альфе
банк: банк банке банка
аналитик: аналитика аналитик аналитиков аналитикам аналитики аналитиком
мобильн: мобильных
приложен: приложений
кейс: кейс
вопрос: вопрос
зада: задают
постоя: постоянно постоянного
привет: привет
зовут: зовут
тагир: тагир
хайрутдин: хайрутдинов
старш: старший
прошл: прошлый
посет: посетил
примерн: примерно
профильн: профильных
конференц: конференций
проч: прочих
мероприят: мероприятий мероприятиях
рассказыва: рассказываю рассказываем
люд: людям людей
геймификац: геймификация
как: какое какие какого
влиян: влияние
оказыва: оказывает
бизнес: бизнес
пример: примере пример
проект: проектов проект проекте проекты
сам: самый
част: частый частых
маркетолог: маркетологов маркетологам
овнер: овнеров овнерам
реальн: реально реальном реальную реальное
пойдет: пойдет
реч: речь
расскаж: расскажу расскажем
эффект: эффект эффекта
получа: получает получают получать
использу: используем используя
дела: делать делали делал
игр: игры игр
симулятор: симулятор
мошенник: мошенника мошенников
предлага: предлагали предлагает
клиент: клиентам
форм: форме
провер: проверить
сво: сво своими свой
умен: умение
распознава: распознавать
интересн: интересна интересно
продакт: продакт
чита: читать
дал: далее
голос: голосов
добав: добавить
закладк: закладки
комментар: комментарии
новост: новости
основн: основные основных основной основная
инструмент: инструменты инструментах инструмент инструментов
работ: работы работе работу работа
введен: введение
начина: начинающих
ов: ов
песочниц: песочницы песочница
над: надя
занима: занимаю
должност: должность
специализир: специализируется
хоч: хочу
подел: поделиться поделюсь
информац: информацией информации информация
использ: использую используется
рассказа: рассказать
кажд: каждом каждому
подробн: подробнее подробности
апр: апр
создан: создание создания создании
перв: первой первое первая первую
базисн: базисной базисных
модел: модели модель моделей моделями
сегментац: сегментации сегментация сегментацию
изображен: изображений изображения изображениями
обработк: обработка обработкой обработки
машин: машинное машинного машины
обучен: обучение обучения обучению обученной обучении
искусствен: искусственный
интеллект: интеллект
перевод: перевод
распознаван: распознавание
пиксел: пикселей
принадлежа: принадлежащих
объект: объекту
базов: базовая базовых
задач: задача задачи задачу задач задачей
компьютерн: компьютерного
зрен: зрения
используем: используемая
широк: широком
спектр: спектре
применен: применений применение применения
анализ: анализа анализом анализ
научн: научных
снимк: снимков
редактирован: редактирования
фотограф: фотографий
точн: точной
конкретн: конкретные конкретно
треб: требуется
высокоспециализирова: высокоспециализированный
труд: труд труда
техническ: технических техническая
эксперт: экспертов экспертом
имеющ: имеющих
доступ: доступ
инфраструктур: инфраструктуре инфраструктура
и: ии
объ: объ
мам: мам
тщательн: тщательно
аннотирова: аннотированных
относя: относящихся
предметн: предметной
област: области областей область
лаборатор: лаборатория лаборатории
стрем: стремится
сдела: сделать
доступн: доступной доступна доступный
основа: основав основан
датасет: датасет датасету датасета датасетов
см: см
наш: нашей нашу наших
исследовательск: исследовательской исследовательских
публику: публикуем
масок: масок
крупн: крупнейший крупнейшего крупный
мир: мире миров миром
использова: использовать использован использованной
множеств: множестве множество
разн: разных
стимулирова: стимулировать
дальн: дальнейшие
исследован: исследования исследование
открыва: открываем
позвол: позволяя
цел: целях целом целого целой целей цель
открыт: открытой
лиценз: лицензии лицензией
может: можете
протестирова: протестировать
дем: демо
собствен: собственными собственных собственном собственно
принадлеж: принадлежит
корпорац: корпорации
призна: признана
экстремистск: экстремистской
организац: организацией
деятельн: деятельность
росс: россии
запрещ: запрещена
типичн: типичных типичные
ошибок: ошибок
исправ: исправить
управлен: управление
персонал: персоналом
карьер: карьера
индустр: индустрии
туториа: туториал
явля: является
социальн: социальных
сет: сетей сети
ит: ит
отрасл: отрасли
имеет: имеет
пользовател: пользователей пользователями пользователи пользователя
ежемесячн: ежемесячно
ктивн: ктивными
отклика: откликаются
ваканс: вакансии вакансий
ответ: ответов ответим
подход: подходы
помога: помогают
увелич: увеличить
запрос: запросы
например: например
прям: прямое
общен: общение общения
работодател: работодателями работодатели
верн: верного
результативн: результативного
ряд: ряд
подготовительн: подготовительных
действ: действий
обновлен: обновление
исправлен: исправление исправления
ошибк: ошибки
встреча: встречаются
негативн: негативно
повлия: повлиять
уменьш: уменьшить
шанс: шансы шанс
получен: получение полученные
отклик: откликов
сто: стоит стоят
повторя: повторять
одн: одни одних одно одну
рассмотр: рассмотрим
соверша: совершают
мног: многие многое многих многом
поясня: поясняем
повыс: повысить
эффективн: эффективность
счет: счет
истор: истории история историю
оптимизиру: оптимизируем
настройк: настройка настройке
выбор: выбор
метод: метода
леру: леруа
мерл: мерлен
использует: используете
наверняк: наверняка
задумыва: задумывались
оптимизац: оптимизации оптимизация
пост: посте
наработк: наработками
настроек: настроек
благодар: благодаря
котор: которым котором которое
получ: получили получить получился
позитивн: позитивные
результат: результаты результате результат результатам
улучш: улучшили
сервис: сервисов сервис сервисы
стратег: стратегии
балансировк: балансировки
нагрузк: нагрузки нагрузка
нод: нодами ноды
кластер: кластера
процессор: процессоров
рамк: рамках
косяк: косяками
ныря: ныряйте
кат: кат катом
дава: давайте
обсуд: обсудим
хорош: хорошего
рандом: рандома
улучша: улучшали
мэтчинг: мэтчинг мэтчингу
продукт: продуктом продукт
профессиональн: профессиональных
дружеск: дружеских
знакомств: знакомств
встреч: встречи встрече встреч
внутр: внутри
тематическ: тематических
сообществ: сообществ
баз: базе баз базы
телеграм: телеграма
понедельник: понедельник
бот: боты бота
распределя: распределяют распределяется
пар: парам пар
самостоятельн: самостоятельно
списа: списались
договор: договорились
вжив: вживую
онлайн: онлайн
станов: становилось становится
уход: уходить
случайн: случайного случайности
распределен: распределения распределенных распределение распределением
успешн: успешных
состоя: состоявшихся
кофаундер: кофаундер
паш: паша
козл: козлов
п: п
тр: тр
пушкар: пушкарь
перешл: перешли
умн: умному умные умного
подбор: подборе
собеседник: собеседников
вышл: вышло
аспект: аспекты
формирован: формирования
маппинг: маппинга
витрин: витрины витрин
миграц: миграции
настоя: настоящее настоящим
команд: команда команде
выполня: выполняет выполнялось выполняете
реализац: реализации реализацией
нескольк: нескольких
появля: появляется
потребн: потребность потребности
построен: построения
оп: опыт
субд: субд
импортозамещен: импортозамещения
отечествен: отечественным
обзор: обзор
тем: тема темы темой
хайп: хайпе
свет: свет
клин: клином
сош: сош
лся: лся
так: таки такого таких таким
попробу: попробуем
разобра: разобраться
обойд: обойд
мся: мся
код: кода код
общ: общие
понят: понятия
бол: боль
страдан: страдание
быстр: быстро
геода: геоданными геоданных геоданные
билайн: билайн
геоинформацион: геоинформационные
статистик: статистика
взаимодейству: взаимодействуем
решен: решения решение решений
пробл: проблем
связа: связанных
хранен: хранением хранения
объем: объема
пространствен: пространственных
бывш: бывший
денис: денис
афанас: афанасьев
жен: женя
рыбалкин: рыбалкин
инженер: инженер
выбра: выбрали
умеет: умеет
показа: показать
вообщ: вообще
возьм: возьмем
расчет: расчета
посещаем: посещаемости
хоккейн: хоккейных
матч: матчей
москв: москве
никак: никак
пле: плей
офф: офф
разгар: разгаре
порядк: порядку
люб: любой любого
смартфон: смартфон
фитнес: фитнес
браслет: браслеты
оборудован: оборудование
передава: передавать
местоположен: местоположении
потребительск: потребительского
желез: железа
серьезн: серьезную
эволюц: эволюцию
прош: прош
л: л
интернет: интернет
вещ: вещей вещь
прич: причем
классическ: классический
дом: дома
полезн: полезностей полезная
индустриальн: индустриальный
заточен: заточенный
мониторинг: мониторинг
технологическ: технологических
сист: систем
сельск: сельское
хозяйств: хозяйство
окружа: окружающей
сред: среды
следств: следствием
развит: развития
количествен: количественном
качествен: качественном
план: плане плану
ощутим: ощутимый
рост: рост
ма: ма
устройств: устройства устройство
генерир: генерируют
разбер: разберемся разберем
нужн: нужны
частотн: частотный частотной
байесовск: байесовский байесовской
оценива: оцениваем оценивать
неполн: неполной
разметк: разметке разметки разметка разметкой
касперск: касперского
информацион: информационная информационной
безопасн: безопасность безопасности
программирован: программирование программирования
алгоритм: алгоритмы
ала: алан
савушкин: савушкин
дат: дата
сайентист: сайентист
отвеча: отвечаем отвечаете
числ: числе числа
фильтрац: фильтрацию
нерелевантн: нерелевантных
алерт: алертов
телеметр: телеметрии
киберугроз: киберугроз
реша: решали решать
оценк: оценки оценкой
услов: условиях условия
возникнут: возникнуть
сут: сути
дол: доля долю
постро: построить
доверительн: доверительный
интерва: интервал интервала
легч: легче
спор: спорить
добавл: добавлю
узна: узнаете
использован: использовании использования использование использованием
основ: основе
сер: серии серого
проверк: проверки
гипотез: гипотез
капот: капотом
гипергеометрическ: гипергеометрическое гипергеометрического
биномиальн: биномиальное
спойлер: спойлер
важн: важно важна
понима: понимать
пользу: пользуясь
точк: точки
скрест: скрестить
бет: бета
гибрид: гибрид
качеств: качестве качеством качества
сопряжен: сопряженного
априорн: априорного
прикол: прикол
докат: докатились
перечислен: перечисленного
выш: выше
тизер: тизер
обширн: обширным
стал: стало
разбира: разбираться
причин: причин
синтетическ: синтетические синтетических
сбор: сбор сбора
длительн: длительным
дорогостоя: дорогостоящим
занят: занятием
проблем: проблемы
разнообраз: разнообразием разнообразия
счаст: счастью
подобн: подобные
помощ: помощи помощью
непохож: непохожи
соревнован: соревнования
отличн: отличный
готов: готовой готовое готовы
приход: приходится приходя
собира: собирать
упорядочива: упорядочивать
очища: очищать
процесс: процесс процесса
долг: долгим
неудобн: неудобным
неточн: неточным
опасн: опасным
конц: конце конца
оказа: оказаться
соответств: соответствуют
ваш: вашим
требован: требованиям требование
дисбаланс: дисбаланс
класс: классов
мар: мар
упрост: упростить
запуск: запуск
сценар: сценарии сценариев
виртуальн: виртуальной
поход: походы
непредсказуем: непредсказуемая непредсказуемое
участник: участниками
вмешива: вмешивается
элемент: элемент
забывчив: забывчивости
ситуац: ситуациях
выруча: выручает
швейцарск: швейцарский
нож: нож ножа
гарантир: гарантирует
минимальн: минимальные
групп: группы
удовлетвор: удовлетворены
консерв: консервы
бинт: бинт
разреза: разрезать
главн: главное
эконом: экономит
мест: место
рюкзак: рюкзаке
небольш: небольшой небольшая
хочет: хочется
отдельн: отдельных
компонент: компонентов
удобн: удобно
дор: дорого
существова: существовало
компактн: компактное
сраз: сразу
набор: набор
усажива: усаживайтесь
костр: костра
поудобн: поудобнее
пришл: пришло
партицирован: партицирование
распредел: распредел
нны: нные
систем: системы система
верс: версия версию
совместим: совместимая
секционирова: секционированными
таблиц: таблицами таблиц таблицы таблицах таблице
предыстор: предыстория
ограничен: ограниченной ограниченным
вариант: вариантом
наследован: наследования
начин: начиная
мож: можем
декларативн: декларативный
синтаксис: синтаксис
определен: определения
парадигм: парадигмы
раздел: разделов разделы
слиян: слияния
вобра: вобрал
разбиен: разбиения
сохран: сохранив
взят: взять
обо: обоих
специалист: специалиста специалистом специалист
защ: защите
алекс: алексей
мегапьютер: мегапьютер
поня: понять
потребова: потребовалось
законч: закончил
чгу: чгу
чебоксарск: чебоксарский
государствен: государственный
университет: университет
специальн: специальности специальное
защит: защита
нача: начал
трудов: трудовой
пут: путь
телекоммуникацион: телекоммуникационной
пошл: пошло
поеха: поехало
из: изо
дня: дня
проверя: проверял
почтов: почтовый
ящик: ящик ящика
налич: наличие
уведомлен: уведомлений уведомления
событ: событиях
иб: иб
поступа: поступали
различн: различных различные
источник: источников источники
включ: включая
обнаружен: обнаружения
вторжен: вторжений
брандмауэр: брандмауэры
антивирусн: антивирусное
программн: программное
обеспечен: обеспечение
долж: должен
знат: знать
предупрежден: предупреждения
определ: определить определ определиться
представля: представляют
угроз: угрозу
ложн: ложное
срабатыван: срабатывание
ультимативн: ультимативная
дорожн: дорожная
карт: карта
изучен: изучения
знан: знаний знание
учебн: учебный
роадмэп: роадмэп
поможет: поможет
науч: научиться
практикова: практиковаться
изуча: изучать
язык: языка языков
протяжен: протяжении
старт: старт
поэт: поэтому
рекоменд: рекомендую
приступ: приступить
согласн: согласно
необходим: необходимо
разработчик: разработчику
проектирован: проектирование
значен: значение значения значений
обозначен: обозначения
отсутств: отсутствия отсутствие
отлича: отличается
пуст: пустой
строк: строки
нулев: нулевого
означа: означает означало
либ: либо
ячейк: ячейке
появлен: появления
длин: длинна
начал: начале
х: х
год: годов
д: д
камерер: камерер
р: р
бойд: бойд
предлож: предложили
реляцион: реляционную реляционной
полн: полной полная
зам: замены замена
иерархическ: иерархических
сетев: сетевых
актуальн: актуальны
предполага: предполагала
возможн: возможность возможности
структур: структуры структура
первоначальн: первоначально
созда: создан создал
интегральн: интегральный
тип: типа
неизвестн: неизвестно
разработа: разработана разработанных
реализова: реализован
маркер: маркер
указыва: указывает
столбц: столбце
образ: образом
неопределен: неопределенное неопределенный
некотор: некоторые
операц: операцию операции
содержа: содержащем
привод: приводить
нежелательн: нежелательным
поведен: поведение
обязательн: обязательно
указан: указание
вычислен: вычислений
отметк: отметки
глубок: глубокие глубоком глубокого
нейросет: нейросети
спуст: спустя
взгляд: взгляд
ян: янна
лекун: лекуна
соавтор: соавторами
нну: нную
историческ: историческую
ценност: ценность
поскольк: поскольку
наскольк: насколько
известн: известно
нейрон: нейронной нейронов
обратн: обратного
распространен: распространения
учитыва: учитывать
крошечн: крошечный
цифр: цифр
градац: градациях
размер: размером размер
тысяч: тысяча
ощуща: ощущается
вполн: вполне
современ: современной современная
описа: описана
архитектур: архитектура
функц: функция
потер: потерь
привед: приведены
отч: отч
величин: величинах
экспериментальн: экспериментальных
классификац: классификации
обуча: обучающего
тестов: тестового
узнаваем: узнаваемо
воспринима: воспринимается
написа: написанная
реш: решил решили
воспроизвест: воспроизвести
развлечен: развлечения
ещ: ещ
упражнен: упражнение
природ: природы
прогресс: прогресса
важ: важен
оптимальн: оптимальную
подпоследовательн: подпоследовательность
автоматизац: автоматизации
чат: чатов чат
столкнул: столкнулись
планирован: планирования
этап: этапов
возника: возникает
охват: охватить
невозможн: невозможно
многочислен: многочисленности
изменен: изменения
содержан: содержания
покр: покрыть
очеред: очередь очереди
фиксирова: фиксированный
период: период
ресурс: ресурсов
достич: достичь
максимальн: максимального
постановк: постановку
формализац: формализацию
мнен: мнение
активн: активному
популярн: популярной
датасаентист: датасаентистом
модн: модно
говор: говорят
рекламк: рекламки
попада: попадаются
глаз: глаза
ход: ходят
слух: слухи
человек: человека
курс: курсов курсы
оффер: оффер
крайн: крайне
легк: легко
обязан: обязанности
вход: входить
заказчик: заказчика
закидыва: закидывать
принцип: принципу
черн: черного
кстат: кстати
плат: платят
немерен: немереное
денег: денег
душераздира: душераздирающей
попробова: попробовать
отговор: отговорить
остав: оставить
куч: кучу
брат: браться
дел: дело деле
помоч: помочь
встат: встать
истин: истинный
яндекс: яндекса яндекс яндексе
макс: максим
бабенк: бабенко
руковож: руковожу
отдел: отделом
технолог: технологий
нных: нных
вылож: выложили
опенсорс: опенсорс
платформ: платформу
инфраструктурн: инфраструктурных
десятилетн: десятилетнего
возникновен: возникновения
нуж: нужен
опиш: опишем
ключев: ключевые
обознач: обозначим
репозитор: репозитории
наход: находится
серверн: серверный
разв: разв
ртыван: ртывания
веб: веб
интерфейс: интерфейс
клиентск: клиентский
распростра: распростран
позволя: позволяет
жела: желающим
загруз: загрузить
сервер: серверы
дорабатыва: дорабатывать
нужд: нужды
сюд: сюда
вклад: вклад
аккаунт: аккаунт
войт: войти
регистрац: регистрация
хаб: хабы
сайт: сайта
документ: документы
соглашен: соглашение
конфиденциальн: конфиденциальность
услуг: услуги
корпоративн: корпоративный
медийн: медийная
реклам: реклама
нативн: нативные
образовательн: образовательные
программ: программы
стартап: стартапам
спецпроект: спецпроекты
дзен: дзен
поддержк: поддержка
вернут: вернуться
стар: старую
big: big
data: data
rss: rss
tagir: tagir
analyz: analyzes
mine: mining
nadejda: nadejda
cherneva: cherneva
engin: engineering engineer
python: python
kucev: kucev
segment: segment
meta: meta
ai: ai
model: model
sam: sam
billion: billion
mask: mask
dataset: dataset
sa: sa
b: b
apach: apache
platform: platforms
techrecruit: techrecruiter
linkedin: linkedin
remot: remote
inmail: inmails
rustoherox: rustoherox
nifi: nifi
flow: flow
load: load
balanc: balancing
schedul: scheduling
merg: merge
open: open
sourc: source
concurr: concurrent
task: tasks
run: run
durat: duration
record: record
randomcoffeeru: randomcoffeeru
random: random
coffe: coffee
acmetr: acmetric
neoflex: neoflex
oracl: oracle
postgresql: postgresql
mv: mvs
amazon: amazon
lex: lex
gpt: gpt
natur: natural
languag: language
process: processing
chatgpt: chatgpt
openai: openai
deni: denis
afanasyev: afanasyev
sedona: sedona
beelin: beeline
tech: tech
geospark: geospark
iot: iot
iiot: iiot
naiv: naive
bay: bayes
true: true
posit: positive
rate: rate
scienc: science
kasperski: kaspersky
manag: managed
detect: detection
respons: response
mdr: mdr
tpr: tpr
kaggl: kaggle
selenzorn: selenzorn
selectel: selectel
ml: ml
analyt: analytics
virtual: virtual
machin: machine
davm: davm
edeshina: edeshina
greenplum: greenplum
southbridg: southbridge
devop: devops
world: world
db: db
megaalex: megaalex
badcasedaili: badcasedaily
sql: sql
roadmap: roadmap
null: null
d: d
chamberlin: chamberlin
r: r
boyc: boyce
andrej: andrej
karpathi: karpathy
backpropag: backpropagation
appli: applied
handwritten: handwritten
zip: zip
code: code
recognit: recognition
x: x
prinkov: prinkov
garag: garage
tourmalinecor: tourmalinecore
maxim: maxim
babenko: babenko
ytsauru: ytsaurus
c: c
bigdata: bigdata
yt: yt
github: github
s: s
sdk: sdk
java: java
moat: moat
aleron: aleron
alexanderkuk: alexanderkuk
syurmakov: syurmakov
dvideo: dvideo
i: i
shutov: shutov
m: m
shukshinivan: shukshinivan
o: o
cufl: cufl
q: q
varagian: varagian
scientist: scientist
facebook: facebook
twitter: twitter
vk: vk
telegram: telegram
youtub: youtube
habr: habr
