хабр: хабр хабре хабру
откр: открыть
список: список
стат: стать статьи статье статей
автор: автором авторы автора авторов
поток: потоки
разработк: разработка разработку
администрирован: администрирование
дизайн: дизайн дизайном
менеджмент: менеджмент
маркетинг: маркетинг
научпоп: научпоп
поиск: поиск поисках
профил: профиль
обнов: обновить
рейтинг: рейтинг рейтинга
игр: игры игр игру игра игре играх игрой играми
игров: игровые игрового игровой
консол: консоли
камен: камень
ножниц: ножницы
бумаг: бумага
компан: компании компаниями компания компаний
подряд: подряд
скопирова: скопировать
ссылк: ссылку ссылки ссылке
показыва: показывать
нов: новые новую нового
лучш: лучшие лучших лучшую
порог: порог
уровен: уровень
сложност: сложности
прост: простой простым
средн: средний
сложн: сложный сложную сложная
примен: применить
час: часов часа часами
портативн: портативные
весн: весны
модел: моделей модели
сто: стоит стоят
обрат: обратить
вниман: внимание
прочтен: прочтение
мин: мин
количеств: количество количества
просмотр: просмотров
блог: блог
гаджет: гаджеты
компьютерн: компьютерное компьютерного компьютерных компьютерные
желез: железо
выходн: выходные
отдыха: отдыхать
вид: видов видах виде
отдых: отдыха
видеоигр: видеоигры видеоиграх видеоигр
устройств: устройств устройство устройства
созда: создано созданную создающая
включ: включая
известн: известных известной известным
девайс: девайсов девайсах девайс девайсе
именит: именитые
создава: создаваемые создавала
небольш: небольшими
либ: либо
организац: организациями
врод: вроде
специализир: специализируются
сред: среди
многообраз: многообразия
весьм: весьма
удачн: удачные
позволя: позволяют позволяет
игра: играть играют играющих
дорог: дороге
дом: дома
тв: тв
клавиатур: клавиатур
контроллер: контроллеров
так: таких такого такую
пойдет: пойдет
реч: речь
чита: читать читали
добав: добавить
закладк: закладки
комментар: комментарии
новост: новости
разрабатыва: разрабатывали
ретроспектив: ретроспектива
хот: хотите
дарк: дарк
соулс: соулса
стратег: стратегий стратегию
добр: добро доброго
пожалова: пожаловать
старкрафт: старкрафт
вспомн: вспомним вспомнить
культов: культовую культовой
реальн: реальном
корпорац: корпорацией
конц: конце конца
х: х
ещ: ещ
эталон: эталоном
качеств: качества
дела: делали делаем
хорош: хорошие хороша
провалива: проваливались
настольк: настолько
популярн: популярной популярное популярных популярные
стал: стала стали
официальн: официальной
религ: религией
национальн: национальным
кибер: кибер
спорт: спортом
азиатск: азиатской
стран: страны странах
бородат: бородатые
легенд: легенды
глас: гласят
отц: отцы
государств: государства
отдава: отдавали
дочер: дочерей
жених: женихов
способн: способных способное способности способностям способностях
обыгра: обыграть
мультиплеер: мультиплеере
запа: запала
сердечк: сердечко
любител: любителям
годн: годных
просчитыва: просчитывать
шаг: шаг
шахмат: шахматах
общ: общем
приятн: приятно приятнее
поговор: поговорить поговорим поговорили
правильн: правильно
подсчита: подсчитал
стукнул: стукнуло
одн: одним одна одно одному
слов: словом
праздник: праздник
голос: голосов
мар: мар
какодемон: какодемон
динозавр: динозавре
установк: установка
японск: японский
наладонник: наладонник
настройк: настройка
туториа: туториал
здравств: здравствуйте
уважа: уважаемые
друз: друзья друзьями
попа: попался
рук: руки
маленьк: маленький
динозаврик: динозаврик
об: обо
порядк: порядку
понят: понятию
обречен: обреченность
рок: рок
судьб: судьба
упоминан: упоминании
назван: названия названием
вспомина: вспоминается вспоминают вспоминал вспоминаем
незабыва: незабываемый
рык: рык
чудовищ: чудовищ
безумн: безумная
динамичн: динамичная динамичный динамичную
музык: музыка
одноглаз: одноглазый
начина: начиналось начинала
существ: существует
челлендж: челлендж
запуска: запускать
мальск: мальски
имеет: имеет
диспл: дисплей
дан: данной даниил данных данный данном
попыта: попытаемся
систематизирова: систематизировать
знан: знания
вопрос: вопросу вопросы вопрос
разворачиван: разворачивания
операцион: операционной
ти: ти
летн: летней
давност: давности
подхват: подхватив
потянут: потянуть
небесполезн: небесполезно
установ: установить
финал: финале
демонстрац: демонстрация
запуск: запуск запуска
догада: догадались
мир: мир
геодезическ: геодезической
сфер: сфере
алгоритм: алгоритмы
работ: работа работе работы
график: графикой
перевод: перевод
писа: писал
анализ: анализом
процедурн: процедурной
генерац: генерации
изуч: изучим изучая
уютн: уютным
мо: моих
любим: любимых любимой
разработчик: разработчиков разработчик
оскар: оскаром оскара
сталберг: сталбергом
скриншот: скриншоты
наполовин: наполовину
технологическ: технологическое
дем: демо
итог: итоге
настоя: настоящую настоящей настоящее
маг: магию магия
разобра: разобраться
работа: работает
счаст: счастью
уда: удалось
узна: узнать узнала узнал
основн: основные
подробн: подробности подробней
пост: постов
истор: истории историю история
ностальгическ: ностальгические ностальгической ностальгическая
хотел: хотел
рассказа: рассказать рассказали
некогд: некогда
сер: серии серия
дни: дни
наход: находится
фактическ: фактически
коматозн: коматозном
состоян: состоянии
линейк: линейку
знал: знал
геймер: геймер геймеру геймерам геймеров геймера
наверн: наверно
клуб: клуба
котор: котором которое которую
установл: установлена
франшиз: франшизы
зов: зов
тся: тся
хоч: хочу
останов: остановиться
ставш: ставшей
подсер: подсерией
учитыв: учитывая
недавн: недавний
ремейк: ремейк
тем: тема
актуальн: актуальной
вполн: вполне
возможн: возможно возможность
втор: вторую
част: часть
красн: красной
угроз: угрозы
ждет: ждет
слаб: слабо
вер: верится
дал: далее дал
сокровищ: сокровищ
реш: решил
отойт: отойти
постоя: постоянной
рубрик: рубрики
запуст: запустить
рассказыва: рассказывать
современ: современные современному современного
относительн: относительно
могл: могли
пропуст: пропустить
начн: начну
проект: проекта проекты
преодолев: преодолевая
графическ: графический
барьер: барьер
смог: смог
переборот: перебороть
предубежден: предубеждения
погруз: погрузиться
икон: икону
иммерсивн: иммерсивных
люд: людям людей
заста: заставшим
момент: момент
выход: выхода
волн: волне волнует
поборот: побороть
графодрочер: графодрочера
имеют: имеют
преимуществ: преимущества
застав: заставить
сест: сесть
условн: условную
поним: понимая
наскольк: насколько
потряса: потрясающая
наук: наука
знает: знает
красот: красоте красоты красота
научн: научных научно научное научном
исследован: исследований исследование исследования
создан: создания создание
привлекательн: привлекательного привлекательны привлекательности
персонаж: персонажа персонажей
загугл: загуглила
топ: топ
сам: самых
красив: красивых красивые красивое
врем: времен
эволюц: эволюции
женск: женских
очнул: очнулась
дочитыва: дочитывала
человеческ: человеческой
зна: знаю
женщин: женщины
нрав: нравятся
взросл: взрослым
мужчин: мужчинам мужчины
младенц: младенцам
лиц: лица
важн: важна
симметр: симметрия
оранжев: оранжевые
важ: важен
размер: размер
бедер: бедер
угол: угол
поясниц: пояснице
лар: лары
крофт: крофт
фигур: фигура
нормальн: нормальной
англичанк: англичанки
захотел: захотелось
посмотрет: посмотреть
применя: применяют
вывод: выводы
вычита: вычитала
пример: примерами
вед: веду
лампов: ламповый ламповое
кана: канал
заглядыва: заглядывайте
гост: гости
дел: делюсь дело
материал: материалами
геймдизайн: геймдизайн
биологическ: биологически
человек: человека
попрос: попросили
назва: назвать
называ: называют
учен: ученые ученых
чтен: чтения
пар: пары
десятк: десятков
скор: скорее
здоров: здоровое здоровье
будн: будни
техпод: техпода
размещен: размещение
сервер: сервера серверы сервер серверу серверов
системн: системное
сетев: сетевые
технолог: технологии технологий
серверн: серверное
направлен: направлений
использ: используют
интерес: интересуются интересен
клиент: клиенты
наш: нашей
поддержк: поддержки поддержка
явля: являются
слыш: слышим
пользовател: пользователи
смогут: смогут
подключ: подключиться
как: какие какими
параметр: параметры
подойдут: подойдут
использова: использовать использовалась использовались
подобн: подобные
задач: задачи
намн: намного
удобн: удобнее удобно
развернут: развернуть
виртуальн: виртуальной виртуальная
машин: машине
никак: никак
завис: зависит
ваш: вашего ваших
пк: пк
придыхан: придыханием
печальн: печальным
вздох: вздохом
последн: последнее
десятилет: десятилетие десятилетий
расстраива: расстраивала
фанат: фанатов
прекрасн: прекрасные
запомина: запоминающиеся
неоднократн: неоднократно
облажа: облажавшись
прода: продала
западн: западный
бизнес: бизнес
грош: гроши
вернул: вернулась вернулся
территор: территории
япон: японии
год: годах годов
владелец: владелец
теплот: теплотой
сердц: сердце
трепет: трепетом
ждал: ждал
хит: хита
японц: японцев
времен: временах
слиян: слияния
сво: своим своя
главн: главным
конкурент: конкурентом
преврат: превратилась
типичн: типичного
корпоративн: корпоративного корпоративный
монстр: монстра
гоня: гоняющегося
прибыл: прибылью
эпох: эпоха
гремел: гремели
тита: титаны
уровн: уровней уровня уровне уровнем
одиночн: одиночный одиночной
редактор: редактором редактор
сдела: сделать сделал
собствен: собственный собственная собственные
кампан: кампании
личн: лично
игрок: игроку игрок игроки игрокам игроками игроков
понрав: понравилась
оригинальн: оригинальная оригинальной
счита: считаю
плох: плохо
собра: собранной
скучн: скучной
больш: большого больших
наброса: набросанных
открыт: открытых
локац: локаций локацию
пришл: пришла
голов: голову
иде: идея
сможет: сможет
максим: максимому
ушл: ушло
месяц: месяца
результат: результате результат результаты
получ: получилось получится
процесс: процесс процессом
трем: тремя
кат: кат
сцен: сценами
минут: минут
выбра: выбрать
глаз: глаз
пал: пал
форт: форт
ресурс: ресурсы
прохожден: прохождение
скача: скачать
след: следующей
сравнен: сравнение сравнению
экономик: экономики экономикой
реальност: реальности
финанс: финансы
песочниц: песочницы песочница
студент: студенты
казанск: казанского
техникум: техникума
информацион: информационных информационной
связ: связи
кан: канев
будник: будник
ил: илья
кураторств: кураторством
преподавател: преподавателя
маннапов: маннаповой
диляр: диляры
фирнандовн: фирнандовны
приня: приняли
решен: решение
рассмотрет: рассмотреть
экономическ: экономическую
сравн: сравнить сравним
многопользовательск: многопользовательская многопользовательские
ролев: ролевая
онлайн: онлайн
имитир: имитирует
фантастическ: фантастическую
вселен: вселенную
участвова: участвовать
различн: различных
деятельн: деятельности
сражен: сражения
промышлен: промышленность
торговл: торговля
политик: политика
мног: многое многих
валют: валюта
межзв: межзв
здны: здные
кредит: кредиты
покупк: покупки
продаж: продажи
товар: товаров
услуг: услуг услуги
рыночн: рыночная
систем: система
устанавлива: устанавливать
цен: цены
конкурирова: конкурировать
друг: другими друг другу
спрос: спрос
предложен: предложение
меч: меч
проб: пробила
днях: днях
скуп: скупая
слез: слеза
доста: достать
полк: полки
покрыт: покрытую
пыл: пылью
коробочк: коробочку
замечательн: замечательной
разрушител: разрушителя
российск: российский
стартап: стартап стартапа стартапам
разработа: разработал
аромадиффузор: аромадиффузор аромадиффузорами
ароматизац: ароматизации ароматизация
фильм: фильмов
развит: развитие развития
производств: производство
электроник: электроники
интерв: интервью
удив: удивить
помещен: помещений
мест: местах
квартир: квартиры
торгов: торговые
центр: центры
магазин: магазины
куп: купить
вручн: вручную
настраив: настраивая
частот: частоту
распылен: распыления
управлен: управление
например: например
домашн: домашнюю
сист: систему
продвинут: продвинутых
вещ: вещах
подход: подходе
изучен: изучению
реакц: реакции
разн: разные разных
аромат: ароматы
использован: использование
цел: целей целом
служб: службе
област: области
нейросенсорн: нейросенсорных
основател: основателем
букреев: букреевым
никит: никитой
двум: двумя
специалист: специалистами
отвеча: отвечающими
техническ: техническую техническая
реализац: реализацию
антон: антоном
васильев: васильевым
воссоздан: воссоздание
ретроигр: ретроигры
позвон: позвоните
куз: кузе
денис: денисом
саврад: саврадым
мед: медиа
контент: контента
эстетик: эстетике
ссср: ссср
виде: видео
эльдорад: эльдорадо
обзор: обзор
релиз: релизом
напомн: напомнили
заезжен: заезженных
сеттинг: сеттингов сеттинг
совет: советов
ин: ином
публик: публике
зарубежн: зарубежной
пропита: пропитанные
дух: духом
разгон: разгон
реверс: реверс
инжиниринг: инжиниринг
детств: детства
интересн: интереснее интересное
кусочек: кусочек
ретр: ретро
археолог: археологии
спуст: спуститься
подземел: подземелье
стар: старых старую
дня: дня
приш: приш
л: л
понятн: понятное понятным
слуг: слугу
базов: базовые
конфигурац: конфигурации
быстр: быстро
утом: утомили
нача: начал началось
изуча: изучать
душевн: душевное
привел: привело
неописуем: неописуемый
восторг: восторг
классик: классику
проч: прочие
случ: случилось
достаточн: достаточно
зайт: зайти
кликнут: кликнуть
мгновен: мгновений
окажет: окажетесь
арен: арене
пор: порой
подбира: подбирает
участник: участников
одинаков: одинаковым
мастерств: мастерства
живущ: живущих
ближ: ближе
обеспеч: обеспечить
латенс: латенси
пинг: пинг
выбор: выбора
режим: режима
соревнован: соревнований
обычн: обычного
сет: сети
людьм: людьми
простот: простота
бол: боли
прошл: прошлом прошлого
требова: требовать
определен: определенного определенных
адрес: адреса
вынужда: вынуждало
координирова: координировать
действ: действия
присоедин: присоединиться
неудобн: неудобное
подключен: подключение
прям: прямую
заставля: заставляло
иска: искать
хост: хостов
простор: просторах
интернет: интернета интернету
утомительн: утомительно
середин: середине
появ: появился
помощ: помощью
соединен: соединение
горазд: гораздо
интуитивн: интуитивно
революц: революция
нанос: наносят
вред: вреда
когнитивн: когнитивным когнитивных
дет: детей дети детях
независим: независимо
продолжительн: продолжительности
жанр: жанра жанров
мозг: мозг мозга
доказательств: доказательство
заседа: заседают
вс: вс
пропа: пропало
умн: умнее
броса: бросают
выз: вызов
опасен: опасениям
родител: родители
слыша: слышали
течен: течение
мол: мол
выбира: выбирают выбираем
прояв: проявят
нездоров: нездоровые
отклонен: отклонения
наверняк: наверняка
стрелялк: стрелялки
жесток: жестокость
ум: уме
подавля: подавляют
гиппокамп: гиппокамп
вызыва: вызывают
депресс: депрессию
ведут: ведут
деградац: деградации
лобн: лобных
дол: долей
заголовк: заголовки
увидет: увидеть
английск: английском
русск: русском
сегмент: сегменте
обеспокоен: обеспокоенные
вообщ: вообще
пыта: пытаются
запрет: запретить
знаком: знакомых
привест: привести
ответ: ответ
опубликова: опубликованное
журнал: журнале
н: н
команд: команда
штат: штатов
проверя: проверяла
изменен: изменения
происход: происходить
увидел: увидела
отлича: отличается
школьник: школьника
мышк: мышки
разруша: разрушаем
миф: мифы
классн: классные
люб: любой
кошел: кошел
групп: группа
перифер: периферия
привет: привет
разбер: разбер
мся: мся
быва: бывают
характеристик: характеристики
гейминг: гейминга
офисн: офисной
постара: постараемся
поня: понять
определя: определяет
предназначен: предназначение
рациональн: рационально
принцип: принципе
выделя: выделять
отдельн: отдельную
категор: категорию
манипулятор: манипуляторов
таков: таковую
сюд: сюда
вклад: вклад
аккаунт: аккаунт
войт: войти
регистрац: регистрация
раздел: разделы
публикац: публикации
хаб: хабы
информац: информация
сайт: сайта
документ: документы
соглашен: соглашение
конфиденциальн: конфиденциальность
медийн: медийная
реклам: реклама
нативн: нативные
образовательн: образовательные
программ: программы
мегапроект: мегапроекты
яндекс: яндекс
дзен: дзен
язык: языка
вернут: вернуться
верс: версию
rss: rss
greiv: greiv
selectel: selectel
shyhartskoi: shyhartskoi
starcraft: starcraft
timeweb: timeweb
cloud: cloud
blizzard: blizzard
rt: rts
mechnix: mechnix
doom: doom
sharp: sharp
zauru: zaurus
sl: sl
c: c
linux: linux
nix: nix
cpu: cpu
ram: ram
patientzero: patientzero
planet: planet
d: d
twitter: twitter
oldfaggam: oldfaggamer
command: command
conquer: conquer
red: red
alert: alert
ruvd: ruvds
bloodstain: bloodstained
ritual: ritual
night: night
system: system
shock: shock
arcanum: arcanum
asya: asya
dyu: dyu
telegram: telegram
gamedevil: gamedevils
substack: substack
oldadmin: oldadmin
vd: vds
parasit: parasite
ev: eve
squar: square
ps: ps
enix: enix
front: front
mission: mission
final: final
fantasi: fantasy
chrono: chrono
cross: cross
xenogear: xenogears
vagrant: vagrant
stori: story
coyot: coyote
fort: fort
crysi: crysis
appl: apples
economi: economy
onlin: online
mmorpg: mmorpg
isk: isk
ancotir: ancotir
sensorylab: sensorylab
iot: iot
barsik: barsik
mvideo: mvideo
atom: atomic
heart: heart
kmatveev: kmatveev
fred: fred
zx: zx
spectrum: spectrum
zeromkx: zeromkx
steam: steam
deck: deck
recoveri: recovery
mode: mode
sega: sega
dendi: dendy
retroarch: retroarch
r: r
type: type
saboteur: saboteur
exolon: exolon
hannabilova: hannabilova
gamespi: gamespy
ua: ua
host: hosting
compani: company
ip: ip
virtual: virtual
explor: explorer
firstvd: firstvds
atari: atari
media: media
psycholog: psychology
xcom: xcom
shop: shop
x: x
mark: marks
alizar: alizar
katyabelkina: katyabelkina
lozga: lozga
ragequit: ragequit
ivansychev: ivansychev
papabubadiop: papabubadiop
pixon: pixonic
tylerskald: tylerskald
facebook: facebook
vk: vk
youtub: youtube
habr: habr
