хабр: хабр
откр: открыть
список: список
стат: стать большую
автор: автором знают запрещена разделы сайта
поток: потоки потока
разработк: разработка разработки разработкой разработку разработке
администрирован: администрирование администрирования
дизайн: дизайн
менеджмент: менеджмент
маркетинг: маркетинг
научпоп: научпоп
поиск: поиск поиска
профил: профиль
обнов: обновить экстренно
рейтинг: рейтинг лидеров
журна: журнал
хакер: хакер злоупотребления
минут: минуты
сам: самые самых могла допустили
новост: новости
безопасн: безопасности безопасность
март: март марта
прочтен: прочтение
мин: мин
количеств: количество
просмотр: просмотров
блог: блог
компан: компании компания компаний компаниями раскритиковали сложности
информацион: информационная информационной
дайджест: дайджест
ежедневн: ежедневно
публик: публикуются
актуальн: актуальные киберугроз
конц: конце
кажд: каждого страницы
месяц: месяца месяце месяцы месяцев
подвод: подводим
итог: итоги итоге
представл: представлен гласило
дистрибут: дистрибутив
учен: ученые
эксперт: эксперты экспертами
призыва: призывают призываем
приостанов: приостановить приостановило
обучен: обучение
и: ии
правоохранител: правоохранители регулирующим
арестова: арестовали арестован
создател: создателя создатель создателей
дрон: дроны передаваемые уникальный перехватить увидели
раскрыва: раскрывают предупреждали
местоположен: местоположение документов
оператор: операторов регионами дрона оружие
ищет: ищет
человек: человека
слил: слил
исходн: исходные исходным исходный исходных позволяет перезаписи протоколу
код: коды кодом код кодов утекшим выполнения
выявл: выявлены
опасн: опасные опасности выявления представляет сопровождавших
уязвим: уязвимости уязвимостями уязвимостей числа
интересн: интересные
событ: события
предназнач: предназначен
безопасник: безопасников
выпуст: выпустила вендор
перв: первую первое компьютерах основной перебора
верс: версию версии
приурочен: приуроченную
десятилет: десятилетию
проект: проекта нативные
нов: новым новую новых остаются
дистрибутив: дистрибутивом
ориентирова: ориентирован
оборонительн: оборонительную
прошедш: прошедшие анб
год: годы раза
усовершенствова: усовершенствовали
специализирова: специализировались
наступательн: наступательную
начина: начинаем
переход: переход
област: область области конкретной
пишут: пишут
дела: делаем
предстартов: предстартовый
запуск: запуск
ознакомительн: ознакомительной
техническ: технической технические дополнительных языка
наход: находится рука
начальн: начальном
этап: этапе
развит: развития развитие
потреб: потребуется
созрет: созреть
может: можете
видет: видеть
направлен: направление направления направленная
котор: котором устройство мотивов флешка
развива: развивается
приня: принять конгресса
участ: участие
формирован: формировании
ран: ранних ранее ведущий
стад: стадиях
включа: включает видим встроенные
защитн: защитных защитные
инструмент: инструментов инструмент обновили прототип
числ: числе число общего
имеет: имеет
специальн: специальную специальный регуляторам
поможет: поможет
нача: начать
работ: работу работы работами
загруз: загрузить
вид: виде оригинальный манипулировать баз
образ: образа дронов
сист: систем систему
сто: стоит
отмет: отметить отметили отметил
соста: состав
вошл: вошли россия
сраз: сразу
захват: захвата
пакет: пакетов пакетами
открыт: открытым открыто открытое открытом открытый зашифрована
настоя: настоящий настоящее
мультитул: мультитул
позволя: позволяющий позволяющая позволяющих баг файле
анализирова: анализировать
расшифровыва: расшифровывать
деобфуцирова: деобфуцировать
декодирова: декодировать
дан: данные данных данными данным данной опасность
помощ: помощью закрашенные
разн: разных самая
опенсорсн: опенсорсный
корреляц: корреляции
оркестровк: оркестровки
управлен: управления
приложен: приложений полученного
распределен: распределенного
сбор: сбора
сетев: сетевых дефицитом отмечает протоколе
платформ: платформа платформы
комплект: комплект
анализ: анализа лабораторным
взлом: взлома взломов взломы
парол: паролей логины
призва: призванный призвали
помоч: помочь
эффективн: эффективно эффективность весьма
организова: организованно
управля: управлять управляемых управляет управлял
сво: своими пилота отдал
пентест: пентеста
един: единый единых
интерфейс: интерфейс
ряд: ряда ряд
криптоалгоритм: криптоалгоритмов
хвата: хватает
иб: иб
специалист: специалистов специалисты активировался
лаборатор: лаборатории лабораториям
касперск: касперского
трет: трети
росс: россии хуже
вынужд: вынуждены вынужден
обраща: обращаться
поставщик: поставщикам поставщики информировали выпущенные
услуг: услуг пользовались конфиденциальность
нехватк: нехватки
собствен: собственных выпустивший
аналогичн: аналогичное конверт
респондент: респондентов
указа: указали
причин: причины причинить
сфер: сфере сферы
аутсорс: аутсорсе
высок: высокая средах
необходим: необходимость необходимо
следова: следовать
требован: требованиям
регулятор: регуляторов государственным
опрошен: опрошенных
недостаток: недостаток
опыт: опыта
кибербезопасн: кибербезопасности
внутр: внутри
организац: организации организаций организацией анализом
финансов: финансовую
выгод: выгоду
связа: связанную связаны связанные связать связан связанных устройствах
оптимизац: оптимизацией
затрат: затрат
поддержк: поддержку оригинальных
штат: штата государственные
покупк: покупку покупки
лиценз: лицензий
разворачиван: разворачивание
масштабирован: масштабирование
инфраструктур: инфраструктуры инфраструктуре инфраструктура
закр: закрылся закрыло закрыть
стал: стало стала стали
известн: известно известный известному известные
арест: аресте ареста
живущ: живущего
нью: нью
йорк: йорке
владельц: владельца владельцу
основател: основателя основатель
хакерск: хакерского хакерский хакерское
форум: форума форумом форум
извест: известен
сет: сети утечь способность заблокировали продажа
последн: последнее последние последнюю протяжении дата
крупн: крупнейшим очередь оперативные единственный
хак: хак
посвящен: посвященным посвященный
утечк: утечкам утечку заявила источником произошла недавними
использова: использовался использовал использовать использованные использованных использоваться полученные адаптера могу
взломщик: взломщиками
вымогател: вымогателями
слив: слива обоих
информац: информации информация слова
ресурс: ресурс ресурса ресурсами мошеннические заблокированных
запущ: запущен
ом: ом
прошл: прошлом прошлый критике печальным
фбр: фбр
сайт: сайт фишинговых песочница
личн: лично личной личным
участник: участники участников
множеств: множеством
громк: громких
утечек: утечек
включ: включая включить
краж: кражу
пользовател: пользователей пользователях утечки активна идентифицирующую исправленную
миллион: миллиона миллионам
недавн: недавние злоумышленник
атак: атаки атака массовую вызванных большинстве локальному малварь
министерств: министерства
юстиц: юстиции
отключен: отключения
насчитыва: насчитывалось китайской
состоян: состоянию
январ: января
бд: бд
набор: наборов
состоя: состоящих
миллиард: миллиардов миллиарда предупреждают
отдельн: отдельных
запис: записей записи записью
вскор: вскоре
оста: оставшийся остался равно журналистам
администратор: администратор
ник: ником причем
окончательн: окончательно
обнаруж: обнаружил сайтов вдвое
продолжа: продолжать
небезопасн: небезопасно
похож: похоже сутки
получ: получили получило получить другом обнаруженную образом электрического бота
доступ: доступ доступа предоставить торговля попали
дел: дело изображение передачи
отключ: отключена
стар: старый компиляции вернуться
сервер: сервер серверов серверы
размеща: размещались
миграц: миграции
проверя: проверял большее возможной
происход: происходит
подозрительн: подозрительного
могл: могло сеть
вызыва: вызывать материалы
беспокойств: беспокойство
писа: писал
одн: одним кито неясным хранятся
проверен: проверенных
упомянут: упомянутый создали
выш: выше
вход: входил входа последних
вошел: вошел
сожален: сожалению
привод: приводит
вывод: выводу выводам доказательства
скор: скорее
машин: машине
использ: используются военные крупные
поэт: поэтому
долж: должен
знат: знать
учетн: учетные учетная учетной
возможн: возможность точно проверят
войт: войти
чувств: чувствую
оказа: оказался дронами
ситуац: ситуации
счита: считать считают считает считал
конфигурац: конфигурации
наш: наших показать
бесконеч: бесконечен
сообщ: сообщили сообщил сообщило фишеров
американск: американские американских хотели
власт: власти
летн: летнему
коннор: коннору
брайан: брайану
фитцпатрик: фитцпатрику фитцпатрик фитцпатрика
предъявл: предъявлены
обвинен: обвинения
хищен: хищением
продаж: продажей прекратила наркокартелей выставленных
конфиденциальн: конфиденциальной раскрывать разная эксплуатация соглашение
принадлежа: принадлежащей политики
гражда: граждан
сша: сша
сотн: сотням
иностра: иностранных
государствен: государственных государственное продает устанавливать
учрежден: учреждений
обвиня: обвиняется обвиняемого обвиняемый
сговор: сговоре
цел: целью целом военных
совершен: совершения
мошенничеств: мошенничества
устройств: устройствами устройствам проблему оказалось продажи специальное установила
случа: случае случав инженерии
признан: признания
виновн: виновным виновных
гроз: грозит
пят: пяти каждом
тюремн: тюремного
заключен: заключения
предста: предстал
суд: судом судя суд
отпущ: отпущен
залог: залог
размер: размере
доллар: долларов
судебн: судебных пытается
документ: документах документы права конфиденциальные
агент: агент
джон: джон
лонгмайр: лонгмайр
рассказыва: рассказывает докладе
помогл: помогло
установ: установить взорвался
пришл: пришли инцидентов
так: таким такого народу
основан: основании ноября
журнал: журналов
активн: активности активность прежнему
интернет: интернет сегменте ресурсов
провайдер: провайдера хостинг
зап: запись
зарегистрирова: зарегистрирована зарегистрированным
адрес: адрес адреса контактной
получен: полученных распространял инструмента предположительно
личност: личностью
помог: помог
частн: частный
разговор: разговор
ход: ходе
нын: ныне
закрыт: закрытого
украден: украденная
баз: база базу старых
попа: попавшая попавший сберспасибо
содерж: содержит содержится
почтов: почтовый
чат: чату сетевой
ликвидац: ликвидации
конфискац: конфискации
пишет: пишет
помим: помимо
выяв: выявило
заб: забыв
вероятн: вероятно
сервис: сервис сервисов регистрации
допуст: допустил формате
сбо: сбой
аккаунт: аккаунтом карт численность
показа: показали хотят карту
привяза: привязаны
мобильн: мобильным скорость
прожива: проживает
дом: доме домой составляло
отц: отца
город: городе крупных
пикскилл: пикскилле
призна: признался признал деятельность
правоохранительн: правоохранительным
орган: органам
присутств: присутствия
адвокат: адвоката
скрыва: скрывается
псевдоним: псевдонимом
владеет: владеет
оценк: оценкам
зарабатыва: зарабатывал
деньг: деньги
домен: доменов мошенников
глас: гласят гласит группы
повлия: повлияет повлиять
рынок: рынок
труд: труда
исследовател: исследователи сможет пострадать
подготов: подготовили
отчет: отчет
систем: системы исходно
европ: европе
мнен: мнению
появлен: появление
генеративн: генеративного
инач: иначе
затронут: затронуть подтвердили ключи
рабоч: рабочих
мест: мест место
большинств: большинство целевыми
отрасл: отраслей
професс: профессий
частичн: частично
подверж: подвержены
автоматизац: автоматизации автоматизация
дополн: дополнены
замен: заменены
искусствен: искусственным искусственного искусственный
интеллект: интеллектом интеллекта интеллект
примерн: примерно
использован: использованием недопустимости влияние
снимет: снимет
нагрузк: нагрузки
работник: работников работники
ожида: ожидается
трудя: трудящихся
потеря: потерять
должност: должность
возьмет: возьмет
част: часть появились
задач: задач
облегч: облегчив
люд: людям людей
работа: работающих росеро влияет
вообщ: вообще
затронет: затронет
выполня: выполняемых сотен
автоматизирова: автоматизированы
наибольш: наибольшей
угроз: угрозе представлять письма объектами
вытеснен: вытеснения
рынк: рынка рынке
офисн: офисные
административн: административные
юрист: юристы юрист
архитектур: архитектуры
проектирован: проектирования
наименьш: наименьшей
сторон: стороны
подверга: подвергаются принимать
уборк: уборке
обслуживан: обслуживанию
ремонт: ремонту
строительств: строительству
широк: широко
общ: общий общих зоне предприятия
рост: рост
миров: мирового
ввп: ввп
остав: оставить
течен: течение
след: следующих следующие следует
десят: десяти атакуемых
команд: команда параметров вредоносные
побед: победила
конференц: конференции
заверш: завершилось
соревнован: соревнование соревнований соревновании
суммарн: суммарно
раскр: раскрыли раскрыть
уникальн: уникальных координаты
скомпрометирова: скомпрометировав
проч: прочего прочие
забра: забрали
бесспорн: бесспорным
лидер: лидером вошла
французск: французская
элу: элуа
бену: бенуа
вандербек: вандербекен
давид: давид
берар: берар
винсент: винсент
деор: деор
танг: танги
дуброк: дуброка
том: тома
бузерар: бузерар
имбер: имбер
счет: счету
успешн: успешные продемонстрировали десятая эксплуатировали
приз: призы
цепочк: цепочка
эксплоит: эксплоитов
переполнен: переполнение разработчиком
хип: хипа
свободн: свободный некоторых
инфотеймент: инфотеймент
тип: типа
трех: трех
ошибок: ошибок
повышен: повышение раскрытию
привилег: привилегий
хост: хосте
увезл: увезла
половин: половина вредоносное
призов: призового
фонд: фонда
заработа: заработала
балл: балла
обогна: обогнав
соперник: соперников
огромн: огромным
отрыв: отрывом
выигрыва: выигрывает
заня: заняли заняться занять
должн: должны должна
исправ: исправить ножницы
продемонстрирова: продемонстрированные картинок финистерре
раскрыт: раскрытые фотографиях привести
дне: дней
опублик: опубликует
подробн: подробности
медвед: медведев
поддержа: поддержал
пиратств: пиратство пиратству
зампред: зампред
совбез: совбеза
рф: рф
дмитр: дмитрий
заяв: заявил жалобу баги
правильн: правильным правильных
скачива: скачивать скачивайте
распространя: распространять получил
пиратск: пиратские
коп: копии
фильм: фильмов
музыкальн: музыкальных
произведен: произведений
недоступн: недоступны
решен: решению технических
западн: западных западной
правообладател: правообладателей
знает: знаете
ищ: ищите
пират: пиратов
ушл: ушли
всяк: всякие прочитаны
нетфликс: нетфликсы
пользова: пользоваться злоумышленники
бесплатн: бесплатно
разбрасыва: разбрасывал
максимальн: максимальный
урон: урон
обанкрот: обанкротились
интерв: интервью
российск: российским обнаружены компанию
сми: сми
комментиру: комментируя
исчезновен: исчезновение
частност: частности
некотор: некоторой некоторые перехват
музык: музыки
онлайн: онлайн
отрицательн: отрицательно
относ: относился угрозам
переплат: переплатить
говор: говорили говорится хакеры
торрент: торрент
трекер: трекерах
тысяч: тысячи
профессор: профессора
разработчик: разработчики разработчикам разработчиками выпущенному
подписа: подписали подписавшиеся
письм: письмо письме накопители
обращен: обращенное
ко: ко
занима: занимающимся занимаются
послан: послании послание
опубликова: опубликованном группа надстройки
некоммерческ: некоммерческой
немедлен: немедленно
мощн: мощных
полгод: полгода
мног: многие
технолог: технологиями технологий
соучредител: соучредитель
илон: илон словам
маск: маск илона уволенный
математик: математик
кибернетик: кибернетик
информатик: информатик
йошу: йошуа
бендж: бенджио
стив: стив
возняк: возняк
глав: глава
эмад: эмад
мострак: мострак
пионер: пионер
исследован: исследований исследование посвятили
стюарт: стюарт
рассел: рассел
гэр: гэри
маркус: маркус
упомина: упоминаются
потенциальн: потенциальные потенциально
риск: риски рисков
обществ: общества обществу общество разногласия
человечеств: человечества человечеству человечество
возника: возникающие сообщения
результат: результате
быстр: быстрого быстро
передов: передовых
отсутств: отсутствие
протокол: протоколов передает подчеркивали защиту
революц: революции
предсто: предстоит
всецел: всецело
оцен: оценить
учест: учесть
комплексн: комплексной
положительн: положительный
эффект: эффект
гарантирова: гарантирован
продвинут: продвинутый продвинутые
повлеч: повлечь
значительн: значительные пунктов
изменен: изменения обнаружения значительное
истор: истории любых
жизн: жизни
земл: земле
планирова: планировать прошло
соответств: соответствующий
осторожн: осторожностью
планирован: планирования
невзир: невзирая
ввяза: ввязались
неконтролируем: неконтролируемую неконтролируемой
гонк: гонку
внедрен: внедрению
цифров: цифровых праве
разум: разумов
никт: никто
поня: понять
предсказа: предсказать
надежн: надежно степенью
контролирова: контролировать
предупрежда: предупреждает картинки произвольный
современ: современные
напрям: напрямую
конкурир: конкурируют
людьм: людьми
выполнен: выполнении команды
поднима: поднимает
экзистенциальн: экзистенциальных
этическ: этических
вопрос: вопросов абсолютистом такими
рассмотрет: рассмотреть
обсуд: обсудить
реш: решить
каса: касаются
генерируем: генерируемой
превосход: превосходят
устарет: устареть
контрол: контроля
цивилизац: цивилизацией
достигл: достигли
момент: момента момент
обуча: обучать
строг: строгим
надзор: надзором
име: имея
уверен: уверенность
развертыван: развертывании
управляем: управляемы
минимум: минимум
пауз: пауза паузы
публичн: публичной
пода: подающейся подает накопителе
проверк: проверке выборочная
затрагива: затрагивать
ключев: ключевых
взят: взята
правительств: правительства позволить
вмеша: вмешаться
ввест: ввести
моратор: мораторий
предлага: предлагается
собра: собраться
вмест: вместе
договор: договориться
создан: создании
смогут: смогут
аудит: аудитов
проводим: проводимых
внешн: внешними
независим: независимыми предполагают
подписант: подписанты
полага: полагают
политик: политикам кампусов
мер: меры
регулирован: регулированием
созда: создать созданными отреверсили модель
водян: водяных
знак: знаков
отлича: отличать
подлин: подлинный
контент: контент
фальшив: фальшивого
проработа: проработать
возложен: возложения
ответствен: ответственности
вред: вред
причинен: причиненный
материал: материалами населению
выдел: выделить
финансирован: финансирование
призыв: призывов
полност: полностью
прекрат: прекратить целях
напрот: напротив
подчеркива: подчеркиваются км
растущ: растущей растущем
конкуренц: конкуренцией
стремя: стремящимися
ниш: нишу
наслажда: наслаждаться
прекрасн: прекрасным
будущ: будущим
преусп: преуспев
мож: можем
расцвет: расцветом
пожина: пожинать
плод: плоды
разрабатыв: разрабатывая
всеобщ: всеобщего
благ: блага
дав: давая
шанс: шанс
адаптирова: адаптироваться
несущ: несущих
катастрофическ: катастрофические
последств: последствия
поступ: поступить
заключа: заключают релизом
вывел: вывели
недел: неделю
отток: отток
средств: средств
криптовалютн: криптовалютной криптовалютную
бирж: биржи биржу
состав: составил интернете доступами значения
издан: издание знаю
ссылк: ссылкой
аналитическ: аналитической
общедоступн: общедоступных
кошельк: кошельках
темп: темпы
снят: снятия
превыс: превысили
обычн: обычную никакого
ускор: ускорились
объявлен: объявления составила
комисс: комиссии
торговл: торговле продажу
товарн: товарными
фьючерс: фьючерсами
обвин: обвиняя
незакон: незаконной связывает
деятельн: деятельности точнее чья
территор: территории
дол: доля регионов увеличением
упа: упала
сообща: сообщают планировали
аналитик: аналитики
утекл: утекли
исходник: исходники
доб: добилась
удален: удаления
внутрен: внутренних
треб: требует
получа: получал преступников
представител: ним доступного палаты
отреагирова: представители
нарушен: отреагировать
закон: нарушение
авторск: закона нескольких нарушающий
прав: авторском авторских авторские возникают
эпох: цифровую
жалоб: эпоху согласно
проприетарн: утечке
представля: проприетарных выяснилось
согласн: угрозу
источник: жалобе определить
прич: пользователь
явн: ник
отсылк: явная
слов: отсылка свободы фото
называ: маска
абсолютист: называет
свобод: вопросах
недовольн: информацию
сотрудник: недовольный
уволен: сотрудник
прежн: маском
репозитор: пользователя сеансе
произошл: репозиториев
неизвестн: утечка
журналист: неизвестно беседе прошедшей всей трое сигнал
доступн: журналисты свободно выполнять перехвата
нескольк: доступны
предостав: прав
жел: доступов
определ: желая перехватывать
сохран: источник
предоставьт: сохраните
люб: предоставьте скачивания репозиторием пользователе оригинал
загрузк: историй
скачиван: загрузки
контактн: любой
сеанс: адресов
форк: любыми
прежд: форками
удаля: прежде файла
наруша: удалять
пыта: документ отмечают условиях
повестк: судебную
вынуд: повестку произошедшее обманом
идентифицир: вынудить
друг: любом файлом
дальн: использованы злоумышленникам
иск: дальнейших
утекш: исков
скача: кодам
подписчик: скачали
несмотр: подписчиков
отмеча: несмотря кусков футов
серьезн: отмечается окажут
тщательн: серьезные
изуч: тщательно пошли
посторон: изучены
выявлен: посторонними
фишер: опасных
заблокирова: сообщила мессенджерах университеты асу
фишингов: заблокировала скрипты
сегмент: российском
раз: интернета
мошенническ: годом
похища: ресурсы
россия: похищали
логин: россиян
банковск: пароли
карт: банковских переводы карты
мессенджер: аккаунты
увелич: составило пытались
зон: увеличилось доменной
выросл: зонах москве
вдво: выросло
составля: обнаружили
злоумышленник: домена компетентным атаками позволяя программы
хостинг: услугами
расположен: провайдеров
основн: расположенных соли
герман: основном
мошенник: германии правило убедительный
угрожа: уязвимость насчитывающий
экстрен: угрожает
ножниц: инструменты отредактированного
обнаружен: исправив рекомендуют
назван: получившую
баг: название исследователей поставщиков
восстанов: позволял
оригина: восстановить
изображен: любого редактировали восстановление
отредактирова: изображения
изначальн: ножниц
пробл: изначально итоговое
редактор: связали главный
скриншот: редактором местоположении
появ: скриншотов доступе
смартфон: появился
релиз: смартфонах
файл: заключалась сохраненном делились проделать исходного одном
открыва: файл
редактирован: открывается
сохраня: редактирования
обреза: сохраняется словом вид
закрашен: обрезанные
равн: помощи
сохранен: новом
картинк: исходной
либ: конфиденциальную
редактирова: либо
публикова: другими
утеч: публиковали
браузер: скриншотах
номер: браузера обнародованы
лиц: номера
нежелательн: лица
откровен: нежелательные
фот: откровенных
замазыва: обрезают
фотограф: замазывают
оригинальн: раскрытия возможно видом
проблем: оригинальной библиотеки
выясн: проблеме
точн: данном прослушивать наркотиков
картинок: обрезанных
восстановлен: успешное
формат: изображений
продела: самое
присво: файлами
идентификатор: присвоен миллиарды
устранен: идентификатор
патч: устранения
обрезк: патч
перезапис: обрезке
неиспользуем: удаляет является
корректн: неиспользуемые
помеща: корректно
конец: помещает
сниз: конец
скорост: снизилась
феврал: мобильного
регион: феврале столицей рейтинге
сравнен: регионах
предыдущ: сравнению
мбит: предыдущим
москв: мбит
объясня: выросла
ухудшен: объясняют
дефицит: ухудшение
оборудован: сетевого сетевое
установк: оборудования
базов: установкой
станц: базовых
очеред: станций
денис: городах
куск: денис
постепен: оборудование
устарева: постепенно
модернизац: устаревает
складск: модернизации
запас: складские
безграничн: запасы
растет: безграничны
разр: растет
качеств: разрыв
столиц: качестве
наращива: операторы
пропускн: наращивают
способн: пропускную
медлен: сетей
трафик: медленнее
местонахожден: трафик
рурск: местонахождение
университет: рурского штатах
бохум: университета
центр: бохуме
имен: центра
гельмгольц: имени
рассказа: гельмгольца
уда: рассказали
расшифрова: удалось немецкие
сигнал: расшифровать тестировали
передава: сигналы
транслир: устройства
координат: транслируют
девайс: оператора
станов: девайсы
востребова: становятся
боев: востребованнее
действ: боевых доступные
вест: действий
наблюден: вести
больш: наблюдение пилотов исследованиям вынудит
высот: большой
провод: высоте
разведк: проводить
оруж: разведку
скрыт: оператор
расстоян: скрыт увеличить
километр: расстоянии
пилот: километров получив
тайн: большая коммерческую
фактическ: тайна
прост: фактически
дешев: простое упомянутого
радиооборудован: дешевое
перехват: радиооборудование продемонстрировал подходящее
доклад: своем
радиосигнал: рассказывают украинских
используем: радиосигналы
радиопротокол: используемый
деконструирова: радиопротокол
увидел: деконструировав
переда: дрон
создава: система
позвол: создавалась команд
регулир: правительствам
беспилотник: правоохранителям потребительских положения
предотвраща: беспилотники
злоупотреблен: предотвращать
зашифрова: говорят протокол деле
способ: открыта
принима: способен
критик: подвергалась
весн: прошлой
украинск: весной определяют
раскритикова: украинские
воен: российские беспилотников
наведен: используют
ракет: наведения
определя: ракет
ответ: радиосигналам
недопустим: ответ
потребительск: использования
украин: устройств
китайск: украине принадлежащий
производител: китайский
прода: производитель первоначальный мошенниками
перехватыва: которое
км: определяя
следовательн: зашифрован
недоступ: следовательно
жела: недоступен
приобрест: желающий
сможет: приобрести
кевин: исследователь
финистерр: кевин
бесед: представитель
передач: журналистами
немецк: зашифрованы
прочита: расшифрованы
прослушива: всякого
определен: точного
положен: определения
доказательств: беспилотника
исследовательск: выводов
групп: исследовательская политической
прототип: опубликовала
расшифровк: получения
пошл: расшифровки
прошивк: изучили
радиосвяз: прошивку
отреверс: радиосвязь
сот: дешевого
тестирова: действия
фут: сигналов
расшир: расстояние
дополнительн: расширить
предполага: решений конверты
мотив: независимо
руководствова: которыми
создав: руководствовалась
рекламиру: создавая
единствен: рекламируя затронуты
подходя: единственно
факт: доступность
легк: факт привлекает
окажут: легко
влиян: серьезное
квадрокоптер: использование
враждебн: квадрокоптеров
услов: враждебных
запрет: пытаются соцсеть
начал: запретить
комитет: начале
палат: комитет
конгресс: представителей
законопроект: принял
президент: законопроект бывшего преступности
стран: президенту национальной
соцсет: стране
устанавлива: запретили
кампус: сетях
национальн: угрожать
впуска: страны
троянск: впускать
кон: троянского
крепост: коня
привнос: крепость
китайц: привносить
манипулирова: китайцы
хот: включать
населен: нашему
разноглас: вызывающие
выставля: обществе
плох: выставляет
свет: плохом
хотел: свете
народ: американскому
задава: вопросами
роб: задавался
джойс: роб
отдел: джойс
анб: отдела
присла: журналисту
флешк: прислали взорвалась аналогичной подключения
бомб: флешку
полиц: бомбой расследований
эквадор: полиция
расслед: эквадора
массов: расследует
медиаорганизац: атаку
все: медиаорганизации
ведущ: журналист
подключен: ранен адаптером
компьютер: подключении корпоративные защиты объектов пятом
взорва: компьютеру флешки
почт: которую изданий
отправл: почте эксплуатировать
редакц: отправлены взрывными
эквадорск: редакции разоблачат
уголовн: эквадорских
расследован: уголовных
хавьер: полиции
чанг: хавьер
льер: чанго получила
конверт: льерена радиостанции
взрывн: предполагаемыми активация
четырех: редакциях
гуаякил: четырех
кит: гуаякиле
взрывоопасн: одна
найд: взрывоопасная
склад: найдена
доставк: складе
посылок: доставке
взрыв: посылок
накопител: взрыва заложенного радио прямо
пострада: накопителя включающие
ленин: пострадавший
артиед: ленин рук
травм: артиеда
рук: травмы запалом
повезл: артиеде
заложен: повезло
заряд: накопитель продюсером
исход: заряда
печальн: исход
активац: сообщается взламывает
произойт: взрывного
электрическ: произойти
содержа: льерены устройстве сведения
гексог: содержать
подтвержд: гексоген
лабораторн: подтверждено
защ: организация
интерес: защите
пресс: интересов
осуд: прессы
нападен: осудила
тро: нападение
рад: журналистов
альвар: угрозами
росер: альваро
радиостанц: работающий
отда: флешкой
продюсер: своему использованного
кабел: продюсеру вредоносного
адаптер: кабель взрывчатка
взрывчатк: содержалась
активирова: заряд
инженер: специалист социальной
майкл: инженер
гровер: майкл
знают: гровер
вредоносн: автора применяли отправляя доле атакованы
демонстрирова: кабеля
взрыва: демонстрировал
исключительн: взрывающиеся
шутк: исключительно
посвят: шутки
маленьк: статью
флеш: маленький
опас: флеш
врод: опасен
семтекс: вроде
борт: семтекса
достаточн: борту
быстродейств: достаточно
запал: быстродействующим
прям: находиться
питан: подано
объясн: питание
мог: объяснил
реальност: использовались
удив: реальности
зна: удивит
сканир: почту
налич: сканируют
взрывчат: наличие
веществ: взрывчатых
предмет: веществ
подобн: предметов
весьм: подобные
террорист: эффективными
надеет: террористов
произошедш: надеется
входя: проверять
корреспонденц: входящую
посыла: корреспонденцию
сигна: посылает
неясн: остается
сообщен: одно достоверность
сопровожда: сообщений
направл: опасную
неустановлен: направлено
политическ: неустановленной эквадорское
разоблачат: представлены
движен: политическое
назва: движение
чест: названное
бывш: честь
рафаэл: президента
корре: рафаэля
наблюда: корреа
всплеск: наблюдается
преступн: всплеск конфискуют
гильерм: президент
ласс: гильермо
связыва: лассо исследуемых
оборот: незаконным
наркотик: оборотом
наркокартел: деятельностью
предприят: сетям промышленные
провел: предприятий
киберугроз: провели
промышлен: актуальных относящихся приходится
выставлен: промышленных
относя: объявлений
стоимост: промышленности
колеблет: стоимость
индустриальн: колеблется
сектор: индустриальный квартал
привлека: сектор
заработк: легким
малоквалифицирова: заработком
преступник: малоквалифицированных
первоначальн: получают
компетентн: продают
протяжен: дальнейшего
тройк: входит
атакуем: тройку
приход: успешная
сложност: общей
зафиксирова: компаниях
инцидент: зафиксировано злоумышленников
вызва: инцидента
кварта: пришлось
целев: сектора
применя: атак
метод: половине
социальн: методы
эксплуатирова: случаев злоумышленнику
привел: успешных
затронул: привели
сведен: затронули
коммерческ: содержащие
персональн: тайну
спецификац: персональную
библиотек: спецификации
аутентифицирова: проблемы
локальн: аутентифицированному
перезаписа: атакующему
защищен: перезаписать
выполн: защищенные
произвольн: выполнить
чтен: идентификаторы конфиденциальным
об: чтение
обработк: обе
параметр: обработкой
бюллетен: кода
выпущен: бюллетеню обновления
буфер: переполнением
привест: буфера
итогов: повышению
завис: проблем
реализова: зависит
конкретн: реализовал
памят: областью
явля: памяти
оперативн: неиспользуемой
корпоративн: использующие услуги
встроен: компьютеры
информирова: заявили
стрем: багах
пыт: стремясь
повыс: пытаясь
осведомлен: повысить
уменьш: осведомленность
подтверд: уменьшить
вендор: крупный затронутым
рекомендац: собственные
предупред: рекомендации первого
влия: предупредивший
эксплуатац: работающие
дает: чтения
например: дает
криптографическ: например
ключ: криптографические
перейт: вендорам
исправлен: перейти
рекоменд: пользователям надежности
примен: рекомендуется
обновлен: применить
вычислительн: поставщиками
сред: вычислительных изменение
степен: высокой
обеспечен: изменений
защит: обеспечения обходит
ас: компьютеров
объект: заблокированы вредоносных вредоносными
подсчита: объекты
хуж: подсчитали
полугод: первым
процентн: полугодием
пункт: процентных
исследуем: среди
увеличен: связывают
атакова: доли
скрипт: относятся
страниц: фишинговые
сберспасиб: компьютере
дамп: части совпадает первом
предположительн: дампа
бонусн: приложения
программ: бонусной
сберправ: утечками
сберлогистик: сберправо
обнародова: сберлогистика
телефон: номеров
структур: телефонов
обо: структура
совпада: сливов
содержат: дампах
дат: содержатся сервисе
рожден: даты
регистрац: рождения аккаунт
хеширова: последнего
сол: хешированные
хран: предупредили
хеш: файлов
устаревш: хеша
алгоритм: устаревшего
реальн: алгоритма
значен: реальные
никак: составит
перебор: обычного
насчита: дампе
выборочн: насчитали
перевод: проверка действительны
действительн: показала
возмож: перевод
видим: возможен
неактивн: видимо
невозмож: неактивна
провер: невозможен
достоверн: проверяем
компиляц: продать
взламыва: поддержка
бутк: активацией
обход: буткит
бот: чат
убедительн: получиться
малвар: мошенник
роутер: атакует
бизнес: роутеры
класс: бизнес
превра: класса
шпионаж: превращая
умолчан: шпионажа
блокирова: умолчанию
надстройк: блокировать
языков: опубликовали
модел: языковую
бразильск: созданную
конфиск: бразильские
обман: преступных
притвор: вынудил
слабовидя: притворившись
нашл: слабовидящим
чипсет: нашли
принадлеж: чипсетах
чья: принадлежит
экстремистск: признана
запрещ: экстремистской
мар: автор
неф: мария
дов: неф
тег: дова
сбербанк: теги
хаб: сбербанк
добав: хабы
закладк: добавить
комментар: закладки
вконтакт: комментарии
карм: вконтакте
андр: карма
письмен: андрей
главн: письменный
комментирова: редактор
публикац: комментировать
лучш: публикации
сутк: лучшие
ноябр: похожие
декабр: основания
числен: декабря
раздел: регистрация
песочниц: авторы
соглашен: авторов
медийн: корпоративный
реклам: медийная
нативн: реклама
образовательн: проекты
стартап: образовательные
мегапроект: стартапам
яндекс: мегапроекты
дзен: яндекс
настройк: дзен
язык: настройка
вернут: техническая
pand: pand
xakep: xakep
ru: ru
kali: kali
purpl: purple
breachforum: breachforums
dji: dji
twitter: twitter
github: github
tpm: tpm
offens: offensive
secur: security
linux: linux
blue: blue
team: team
malcolm: malcolm
suricata: suricata
arkim: arkime
thehiv: thehive
zeek: zeek
wiki: wiki
iso: iso
x: x
amd: amd
cyberchef: cyberchef
defectdojo: defectdojo
dscan: dscan
wrapper: wrapper
nmap: nmap
kubernet: kubernetes
helm: helm
pack: pack
redey: redeye
unicrypto: unicrypto
msp: msp
mssp: mssp
pompompurin: pompompurin
raidforum: raidforums
robinhood: robinhood
acer: acer
activis: activision
baphomet: baphomet
cdn: cdn
est: est
pom: pom
conor: a
brian: conor
fitzpatr: brian
john: fitzpatric
longmir: john
optimum: longmire
onlin: optimum
conorfitz: online
net: conorfitz
verizon: net
googl: verizon
appl: google
ai: apple
type: ai
i: type
pwned: i
conorfitzpatrick: pwned
gmail: conorfitzpatrick
ip: gmail
tor: ip
vpn: tor
icloud: vpn
goldman: icloud
sach: goldman
synacktiv: sachs
pwn: synacktiv
cansecwest: pwn
dai: cansecwest
tesla: day
model: tesla
window: model
maco: windows
ubuntu: macos
eloi: ubuntu
benoist: eloi
vanderbeken: benoist
david: vanderbeken
berard: david
vincent: berard
dehor: vincent
tangui: dehors
dubroca: tanguy
thoma: dubroca
bouzerar: thomas
imbert: bouzerar
oob: imbert
root: oob
toctou: root
time: toctou
check: time
oracl: check
virtualbox: oracle
desktop: virtualbox
uaf: desktop
microsoft: uaf
master: microsoft
austin: master
trend: austin
micro: trend
initi: micro
futur: initiative
life: future
gpt: life
openai: gpt
mila: openai
stabil: mila
geometr: stability
intellig: geometric
binanc: intelligence
wall: binance
street: wall
journal: street
nansen: journal
cftc: nansen
cryptocompar: cftc
dmca: cryptocompare
freespeechenthusiast: dmca
free: freespeechenthusiast
speech: free
absolutist: speech
freespeechenthusiasm: absolutist
group: freespeechenthusiasm
ib: group
gib: ib
acropalyps: gib
pixel: acropalypse
snip: pixel tool
tool: snipping
sketch: snip
cve: sketch
markup: cve
android: markup
pie: android
url: pie
png: url
jpg: png
iend: jpg
telecomdaili: iend
cispa: telecomdaily
gp: cispa
id: gps
droneid: id
aeroscop: droneid hackrf
kevin: aeroscope
finisterr: kevin
sdr: finisterre
ettu: sdr
hackrf: ettus
tiktok: aeroscop
wi: tiktok
fi: wi
byted: fi
silverado: bytedance
acceler: silverado
confer: accelerator
ecuavisa: conference
usb: ecuavisa
xavier: usb
chango: xavier
llerena: chango
lenin: llerena
artieda: lenin
fundamedio: artieda
tc: fundamedios
televisi: tc
n: televisi
teleamazona: n
exa: teleamazonas
fm: exa
lvaro: fm
rosero: lvaro
michael: rosero
grover: michael
mg: grover
o: mg
poc: o
corr: poc
smo: corre
posit: smo
technolog: positive
quarkslab: technologies
trust: quarkslab
platform: trusted
modul: platform
bound: module
comput: bounds
iot: computing
cert: iot
lenovo: cert
oem: lenovo
nuvoton: oem
tmp: nuvoton
errata: tmp
remot: errata
attest: remote
kasperski: attestation
ic: kaspersky
js: ics
html: js
spasibosberbank: html
data: spasibosberbank
leakag: data
breach: leakage
dlbi: breach
email: dlbi
sha: email
uefi: sha
blacklotu: uefi
ieee: blacklotus
bing: ieee
hiatu: bing
excel: hiatus
xll: excel
chan: xll
llama: chan
facebook: llama
flipper: facebook
captcha: flipper
samsung: captcha
exyno: samsung
meta: exynos
vk: meta
telegram: vk
youtub: telegram
habr: youtube
