хабр: хабр хабру
откр: открыть
список: список
стат: стать статьи статье статья статей
автор: автором авторы автор авторов
поток: потоки
разработк: разработка разработкой разработку
администрирован: администрирование
дизайн: дизайн
менеджмент: менеджмент
маркетинг: маркетинг
научпоп: научпоп
поиск: поиск
профил: профиль
обнов: обновить
рейтинг: рейтинг рейтинга
тестирован: тестирование тестирования тестировании тестированием
сист: систем
тестиру: тестируем
компан: компании компаний
подряд: подряд
скопирова: скопировать
ссылк: ссылку
показыва: показывать
нов: новые новой новую новых
лучш: лучшие лучший лучшем лучшим лучших
порог: порог
уровен: уровень
сложност: сложности сложностей сложностями
прост: простой простое простые
средн: средний
сложн: сложный сложных сложной сложными сложно
примен: применить
час: часов
рев: ревью
программистск: программистском
прочтен: прочтение
мин: мин
количеств: количество
просмотр: просмотров
мобильн: мобильных мобильного мобильными
приложен: приложений приложение приложения приложениями
управлен: управление управления управлением
песочниц: песочницы песочница
собеседован: собеседовании
тестировщик: тестировщиков тестировщиком тестировщика тестировщикам тестировщики тестировщик
зада: задаю
вопрос: вопрос
дела: делают делает делать
команд: команде командой команда команду
слыш: слышу
ответ: ответ
разн: разные разной
вариац: вариации
разработчик: разработчики разработчикам разработчика разработчик
вника: вникал
обща: общаемся
никт: никто
знает: знает
питон: питон
тест: тесты тест тестами тестов
написа: написаны написать
н: н
неужел: неужели
подход: подходит подходом
дава: давайте
начн: начнем
ручн: ручного
над: надеюсь
ник: никого
удивл: удивлю
относ: относится
код: коду коде кода код
слыша: слышали
аналитик: аналитики
прототип: прототипов
кейс: кейсов кейс кейсы
внедря: внедряли
работа: работают работать
хорош: хорошие
специалист: специалисты специалистов
б: б
аг: ага
вс: вс
полезн: полезными полезным полезно
встреч: встречами
понима: понимаю
искрен: искренне
счита: считаю считает
обо: обоих
пункт: пунктах
происход: происходит происходят
рационализац: рационализация
страх: страха
страшн: страшно
работ: работу работы работе работа
друг: другим друг другом друга
обнаруж: обнаружить обнаружили
пробел: пробелы
знан: знаниях знания
проигра: проиграть
сравнен: сравнении
узна: узнали узнать
помощ: помощь помощью
культур: культура
чита: читать
дал: далее
голос: голосов
добав: добавить
закладк: закладки
комментар: комментарии
новост: новости
замеря: замеряй
ускоря: ускоряй ускоряет
сократ: сократили сократить
вызов: вызова
метод: метода методом метод методы
блог: блог
сбер: сбер
высок: высокая
производительн: производительность производительности
ретроспектив: ретроспектива
привет: привет
замер: замер замера
сам: самое самых самые самым
упражнен: упражнение
приход: приходится
реша: решать решающим
куч: кучу
разбира: разбираться разбирается
создава: создавать
правильн: правильные
услов: условия
равн: равно равной
получ: получить
результат: результат результатами
погрешн: погрешностью
люб: любой любые любому любого
бесплатн: бесплатный
треб: требует требуют требуется
ресурс: ресурсов
процессор: процессора
зовут: зовут
александр: александр
певненк: певненко
сбертех: сбертехе
вмест: вместе вместо
развива: развиваем
облачн: облачный облачные облачным
сервис: сервис сервисов сервисы сервисам
упроща: упрощает упрощаем
использу: используя используем
концепц: концепцию
хранен: хранения
дан: данными данные данной данных данный
расскаж: расскажу
способ: способ способы способом
бенчмарк: бенчмарков
рассматрива: рассматривать
пример: примере примеры примерами примерах
оптимизац: оптимизации
помогл: помогла
пользова: пользоваться
язык: языком язык языка
построен: построения
график: графиков
набор: набором набор
библиотек: библиотек библиотеки
адаптирова: адаптированы
д: д
проверя: проверяй проверять
доверя: доверяй
функциональн: функциональное функциональностью
облак: облаке облака облако
вычислен: вычисления
веб: веб
перевод: переводят перевод
продукт: продукты продукт продуктов продукту
сталкива: сталкиваются сталкиваюсь
непрост: непростой
процесс: процесс процессы процессе процесса
состо: состоит
множеств: множества множество
вторичн: вторичных
широк: широкой
тесн: тесно
связа: связаны связанными связанные
дума: думать
универсальн: универсальными
переносим: переносимыми
поставля: поставлялись
окружен: окружения окружении
автоматизиру: автоматизируем
микросервис: микросервисов
нача: началось начали
постав: поставили поставил
задач: задачу задачей задач
покр: покрыть
микросервисн: микросервисной
платформ: платформы платформу
котор: которую которым
последн: последние
вправ: вправе
выбра: выбрать
стек: стек стеки
технолог: технологий технологии
самостоятельн: самостоятельно
должн: должны
запуска: запускаться
создан: создании создания
мердж: мердж
реквест: реквеста
изменен: изменения изменением
слома: сломали
выбор: выбор выбора
пал: пал
хотел: хотелось хотел
писа: писать
модн: модном
молод: молод
жном: жном
хоч: хочу
подел: поделиться поделюсь
опыт: опытом опыте опыта
написан: написания
автотест: автотестов автотестами
претенд: претендует
привед: приведу
основн: основные основной основном
принцип: принципы
применя: применяются
поэт: поэтому
ищет: ищете
инструмент: инструмент инструментов инструменты инструмента
покрыт: покрытия
хот: хотите
истор: истории историей
мар: мар
внедрен: внедрение внедрению
автоматизац: автоматизации
проект: проект проектами проекты проекта проекте
игр: игр
автоматизирова: автоматизированных автоматизировать
тестир: тестируют
явля: является являюсь являются
уровн: уровней уровня
проверк: проверки
тестов: тестовыми
подбор: подбора
подходя: подходящей
основыв: основываясь
сво: своем свой сво
подготов: подготовил
руководств: руководство
успешн: успешный
начина: начинается
основ: основы основе
тип: типы типах типов
новичк: новичков новички
добр: добро доброго
пожалова: пожаловать
вероятн: вероятно
пут: путь пути
увлекательн: увлекательном
мир: мире мириться
беспокойт: беспокойтесь
помоч: помочь
разобра: разобраться
различн: различных
использ: используются
современ: современной современных
практик: практике практики
независим: независимо
имеет: имеете имеет
материа: материал
расшир: расширить расширились
умен: умения
существ: существует существующих существующими
особен: особенности
преимуществ: преимущества
рассмотр: рассмотрим
некотор: некоторые
распространен: распространенных
инъекц: инъекции инъекций инъекция
маленьк: маленьких
информацион: информационная
безопасн: безопасность безопасности безопасными безопасно
переход: переходим переходом
техническ: технической техническая
част: части часть
проникновен: проникновение
внешн: внешнего
эксплуатац: эксплуатации
уязвим: уязвимостей уязвимость уязвимостями
позволя: позволяет позволяют
злоумышленник: злоумышленнику злоумышленник
вмешива: вмешиваться
запрос: запросы запросов
баз: базе баз
прав: правило прав
просматрива: просматривать
пользовател: пользователей
доступ: доступ доступом
мног: многих многое
случа: случаях случаи случае
изменя: изменять изменяющемся
удаля: удалять
вызыв: вызывая
постоя: постоянные постоянно постоянным
содержим: содержимом
поведен: поведении
затрат: затраты
витал: виталий
совместительств: совместительству
создател: создателей
называ: называется называют
сфер: сфере сферы
успел: успел
повида: повидать
говн: говна
решен: решений решения решение
рассказа: рассказать
инженер: инженеру
использова: использовать использованы
тул: тул
пентест: пентест
корпоративн: корпоративной корпоративных корпоративный
сет: сети
польз: пользе пользуется
своевремен: своевременных
патч: патчей
бастион: бастион
инфраструктур: инфраструктура
наглядн: наглядно
покажет: покажет
как: каким
быстр: быстрым быстро
катастрофическ: катастрофическим
последств: последствиям
привест: привести
задержк: задержка
установк: установкой
серверн: серверного
важн: важнейшим важному важнее важной важным
компонент: компонентом
верс: версий версию версией версии
сред: средой среди
служб: службы
каталог: каталогов
весн: весной
прошл: прошлого прошло
убед: убедился убедимся
наскольк: насколько
механизм: механизм
обеспечива: обеспечивающий
разграничен: разграничение
преврат: превратиться
главн: главную
дыр: дыру
оборон: обороне
седьм: седьмую
китайск: китайской
срк: срк
крок: крок
восстановлен: восстановление
резервн: резервное резервного
копирован: копирование копирования
софт: софт
пар: пару
недел: недель
систем: системы
порадова: порадовал
рассказыва: рассказывали
семерк: семерке
обеща: обещали
функциона: функционала
пост: посте поста
разбер: разберемся
обновлен: обновление
повлия: повлияло
применен: применения
точн: точнее
сид: сидите
запретн: запретной
присматрива: присматриваете
подробн: подробнее подробный
знаком: знакомиться
кат: катом
разбор: разбор
функц: функций
скриншот: скриншотами
использован: использования использование использованию
цен: цена
ошибк: ошибки
эконом: экономия экономию экономии
привод: приводит приводят
повышен: повышенным повышения
трат: тратам
обсужда: обсуждаем
программн: программного программных
обеспечен: обеспечения обеспечение
говор: говорим
архитектур: архитектуру
навык: навыки
экономик: экономику
абсолютн: абсолютно
бюджет: бюджета
бесконечн: бесконечным
необходим: необходимость необходимо
рациональн: рационального
средств: средств
очевидн: очевидна
необоснова: необоснованную
пор: порой
умалчива: умалчивают
зря: зря
конечн: конечном
итог: итоге итоги
затрагива: затрагивает
качеств: качества качество качестве
бизнес: бизнес бизнеса
сэконом: сэкономить
отвеча: отвечать
привлека: привлекать
коллег: коллега коллегам
андр: андрей
конкретн: конкретных конкретном
популярн: популярные
расскажут: расскажут
марсоход: марсоходов
конференц: конференции конференция
ближайш: ближайшая
обычн: обычного
цел: целых целая цель
дня: дня
онлайнов: онлайновых
москв: москве
возможн: возможностью возможного
уда: удал
нног: нного
подключен: подключения
доклад: докладов
программ: программа программы
готов: готова
пришл: пришло пришли
показа: показать
описан: описания
вод: водится воды
освещ: освещены
сторон: стороны
нагрузочн: нагрузочного
оглавлен: оглавлении
найт: найти
интерес: интересующий
блок: блок
перейт: перейти
сраз: сразу
ещ: ещ
болтолог: болтологии
конкретик: конкретика
тестирова: тестировать
ускор: ускорить
прогон: прогон
многомодульн: многомодульном
хайпов: хайповый
очередн: очередных
абстрактн: абстрактных абстрактные
рассужден: рассуждениях
увол: уволят
сравн: сравним
статическ: статическим
анализатор: анализатором
приглаша: приглашаем
программирован: программирования
экосистем: экосистема
тан: таня
занима: занимаюсь
бухгалтерск: бухгалтерского
финансов: финансового
учет: учета
вед: вед
персонал: персоналом
юридическ: юридических
лиц: лиц
групп: группы групп
справля: справляемся
составлен: составлением составление
сдач: сдачей
отчетн: отчетности
согласн: согласно
действ: действующему
законодательств: законодательству
генерац: генерация генерации
творчеств: творчество
рутин: рутина рутины рутинных
обзор: обзор
долг: долгие
год: годы
стрем: стремились
реалистичн: реалистичному
изображен: изображению
окружа: окружающих
вещ: вещей
симпатичн: симпатичных
наскальн: наскальных
мамонт: мамонтов
шедевр: шедевров шедевра
эпох: эпохи
ренессанс: ренессанса
просвещен: просвещения
век: веке
примерн: примерно
стал: стала
появля: появляться
перв: первая
фототехник: фототехника
пошл: пошло
живоп: живопись
смен: сменила
направлен: направление
реализм: реализма
абстракц: абстракции
скат: скатилось
клякс: клякс
пят: пятен
пот: пот
ков: ков
размаза: размазанных
холст: холсту
поверхн: поверхности
стоимост: стоимостью
миллион: миллионы
доллар: долларов
зачаст: зачастую
совершен: совершенно
непонятн: непонятно
х: х
летн: летний
ребенок: ребенок
мастит: маститый
художник: художник
нейросет: нейросеть
кот: кот
опрокинувш: опрокинувший
банк: банку
варен: варенья
похож: похожие
синтетическ: синтетические
сгенерирова: сгенерированные
обрета: обретают
больш: большую большой большое
ценност: ценность
рынк: рынке
качествен: качественнее
воспроизвод: воспроизводить
проблем: проблемы
появлен: появления
продакшен: продакшене
прогноз: прогнозы
анализ: анализ
обменива: обмениваться
момент: моменты
нул: нуля
схем: схемы
бд: бд
шаг: шаг шаги
иллюстрирова: иллюстрировать
жив: живых
настоя: настоящих
постара: постараемся
эффективн: эффективно эффективного эффективный эффективности
минуточк: минуточку
протяжен: протяжении
эффектн: эффектно
придумыва: придумывать
мысл: мыслить
нюанс: нюансы
организац: организации
небольш: небольшой
представьт: представьте
вперв: впервые
единствен: единственным
чувствует: чувствуете
беспомощн: беспомощным
затронут: затронуть
неочевидн: неочевидные
фантастическ: фантастические
обита: обитают
ива: иван
шевел: шевел
обсуд: обсудить
наболевш: наболевшую
тем: тему
кажд: каждого каждой
фреймворк: фреймворка
комьюнит: комьюнити
чатик: чатики
канал: каналы
форум: форумы
завтрак: завтраки
зайт: зайти
страничк: страничку
топ: топ
сдела: сделать
един: единый
заглушечн: заглушечный
контур: контур
освобод: освободить освободившись
туториа: туториал
ир: ира
пользу: пользуемся
подготовк: подготовке
капл: капли
заглушк: заглушки заглушке
мок: моки
забот: заботиться забот
развернут: развернуть
понрав: понравиться
может: можете
удел: уделить
разнош: разнош
рстны: рстные
хаотичн: хаотично
разв: разв
рнут: рнутые
дорог: дорогие
неэффективн: неэффективные
отдельн: отдельной
одн: одна
времен: временем
накоплен: накоплении
критическ: критической
масс: массы
станов: становятся
фактическ: фактически
неподдержива: неподдерживаемыми
редк: редко
переиспольз: переиспользуются
дел: делится дело
либ: либо
тривиальн: тривиальны
оказа: оказаться
неоптимальн: неоптимальными
представ: представить
рол: роли роль
самаритянин: самаритянина
разда: раздающего
вряд: вряд
мотивир: мотивирует
приличн: прилично
некогд: некогда
отвлека: отвлекаться
разгруз: разгрузим
наш: нашего
трудяг: трудягу
состав: составить
чек: чек
лист: листы листах листе листа листов лист
приветств: приветствую
хочет: хочет
поговор: поговорим
выполн: выполнить
перечисл: перечислены
требован: требования
пропуст: пропустить
дета: детали
помога: помогает
упрост: упростить
структурирова: структурировать
заб: забыть
значительн: значительно
представл: представлены
помогут: помогут
различ: различия различие
доб: добиться добились
успех: успеха
повыша: повышать
узнаваем: узнаваемость
целев: целевая
аудитор: аудитория
мер: мере
устройств: устройствами устройств устройство
предоставлен: предоставления
высококачествен: высококачественных
обе: обеих
жизнен: жизненно
безупречн: безупречных
спланирова: спланированный
мышлен: мышления
клиент: клиентов
возраста: возрастает
элемент: элементом
так: такого
круглосуточн: круглосуточный
лаборатор: лаборатории
облада: обладающие
портативн: портативных
масштабирован: масштабирования
общ: общего
улучшен: улучшения
все: всей
схожест: схожести
сохраня: сохраняется
сниз: снизили снизить
приемочн: приемочных
баг: багов
январ: январе
подвод: подводили
командн: командные
фич: фич
приня: принялся
знающ: знающий
тимлид: тимлид
собра: собрал
минимальн: минимально
значен: значения
желательн: желательно
разик: разика
челлендж: челлендж
каза: казался
невыполним: невыполнимым
сдюж: сдюжили
сюд: сюда
вклад: вклад
ваканс: вакансий вакансии
аккаунт: аккаунт
войт: войти
регистрац: регистрация
раздел: разделы
публикац: публикации
хаб: хабы
информац: информация
сайт: сайта
документ: документы
соглашен: соглашение
конфиденциальн: конфиденциальность
услуг: услуги
медийн: медийная
реклам: реклама
нативн: нативные
образовательн: образовательные
стартап: стартапам
мегапроект: мегапроекты
яндекс: яндекс
дзен: дзен
настройк: настройка
поддержк: поддержка
вернут: вернуться
стар: старую
rss: rss
scarethebear: scarethebear
shift: shift
left: left
sber: sber
java: java
python: python
platform: platform
dataspac: dataspace
backend: backend
servic: a
baa: service
jmh: baas
kotlin: jmh
scala: kotlin
saintalushta: scala
api: saintalushta
vk: api
olegulka: vk
rest: olegulka
assur: rest
allur: assured
tot: allure
pyramid: tot
ci: pyramid
rocket: ci
scienc: rocket
system: science
proqualitycommun: systems
ui: proqualitycommunity
nnowi: ui
uhahatbl: nnowi
tv: uhahatbl
sql: tv
ctf: sql
sqli: ctf
vital: sqli
sqrt: vitalics
app: sqrt
node: app
js: node
github: js
data: github
engin: data automation
test: engineering dubrovinqa
autom: test
secm: engineer
n: secm
microsoft: n
ad: microsoft
window: ad
server: windows
activ: server
directori: active
ekorotkikh: directory
da: ekorotkikh
vinchin: da
simbirsoftqa: vinchin
simbirsoft: simbirsoftqa
qa: simbirsoft
phillennium: qa
heisenbug: phillennium
spring: heisenbug
jug: spring
ru: jug
group: ru
flutter: group
maven: flutter
chatgpt: maven
tatianagol: chatgpt
ozon: tatianagol
tech: ozon
commun: tech
c: community
meetup: c
e: meetup
commerc: e
mgramin: commerce
postgresql: mgramin
devop: postgresql
flavour: devops
dikobra: flavour
neonrac: dikobra
lead: neonrace
denti: lead
ai: denti
milka: ai
root: milka
samokat: root
sre: samokat
dubrovinqa: sre
tinkoff: testing
alizar: tinkoff
natalyarukol: alizar
m: natalyarukol
rko: m
molechka: rko
jnechaeva: molechka
curiousgeorg: jnechaeva
olegchir: curiousgeorge
peter: olegchir
zhizhin: peter
facebook: zhizhin
twitter: facebook
telegram: twitter
youtub: telegram
habr: youtube
