хабр: хабр
откр: открыть
список: список
стат: стать статьи статью статье статья
автор: автором авторы автор авторов
поток: потоки потоках
разработк: разработка разработку разработкой разработки
администрирован: администрирование
дизайн: дизайн
менеджмент: менеджмент
маркетинг: маркетинг
научпоп: научпоп
поиск: поиск поиска
профил: профиль
обнов: обновить
рейтинг: рейтинг рейтинга
высокоуровнев: высокоуровневый
язык: язык языков языком языках языка
программирован: программирования программирование
компан: компании компаний
подряд: подряд
скопирова: скопировать
ссылк: ссылку
показыва: показывать
нов: новые новая нового
лучш: лучшие лучшему лучших
порог: порог
уровен: уровень
сложност: сложности сложностей
прост: простой простое простого простые простых
средн: средний среднего
сложн: сложный сложно сложные
примен: применить
час: часов
уч: учим учусь
английск: английский
прочтен: прочтение
мин: мин
количеств: количество количества
просмотр: просмотров просмотра
изучен: изучение изучения
пожал: пожалуй
новост: новости новостей
языков: языковых
модел: моделях модель моделей
использован: использовании использование использования использованием
надоел: надоели
личн: лично личного
нашел: нашел
полезн: полезное полезные полезна полезных полезными
применен: применение применения
изуча: изучать
числ: числе
разговорн: разговорный
посмотр: посмотрим
предлож: предложить
дел: деле делить дела
товарищ: товарищи
совмест: совместим
чита: читать читайте
дал: далее
голос: голосов голоса
добав: добавить
закладк: закладки
комментар: комментарии
забыва: забывать
встреча: встречайте
фрактал: фракталы фракталов
постепен: постепенно
увеличива: увеличиваем
разрешен: разрешение
математик: математика
машин: машинное
обучен: обучение обученную обучения
искусствен: искусственный
интеллект: интеллект
здравств: здравствуйте
зовут: зовут
никола: николай
стрекопыт: стрекопытов
придума: придумал
подбира: подбирать
гиперпараметр: гиперпараметры
бескомпромиссн: бескомпромиссно
измен: изменить изменилось
порядок: порядок
вычислен: вычислений вычислениями
заявк: заявка
обновлен: обновление
индустриальн: индустриального
стандарт: стандарта
скор: скоро
сможет: сможете
улучш: улучшить
пайплайн: пайплайны пайплайн
замен: заменой
нескольк: нескольких несколькими
строчек: строчек
код: кода коде
част: часть части
перевод: перевод
нейрон: нейронной нейронную нейронная нейронным нейронные
сет: сети сетей сеть сетям
баз: базе
работ: работу работы работа
матричн: матричными
операц: операциями
туториа: туториал
перв: первой первую первого
перевел: перевел
полносвязн: полносвязной полносвязная
разработа: разработана разработано
новостн: новостного
агрегатор: агрегатора
цел: целью цель
фильтрац: фильтрации
нежелательн: нежелательных
посмотрет: посмотреть
руководств: руководство руководстве
увидет: увидеть
рекомендац: рекомендаций
классификац: классификации
тест: теста
явля: является
долг: долгой
краткосрочн: краткосрочной
памят: памяти памятью
забег: забегая
вперед: вперед
скаж: скажу
подошл: подошла
дан: данная данными данные данных данным
вероятн: вероятно
особен: особенность
мо: моего моей
датасет: датасета
эмбеддин: эмбеддином
облада: обладает
хорош: хорошим
качеств: качеством качество качестве
предсказуем: предсказуемостью
стабильн: стабильностью
результат: результатов результат
объясним: объяснимое
переобучен: переобучение
влиян: влияние
архитектур: архитектуры
д: д
немаловажн: немаловажно
быстр: быстро быстрый быстрее
обуча: обучается
отлич: отличие
рад: ради
академическ: академического
интерес: интереса
обуч: обучим
бинарон: бинароной
текст: текста текст текстов
перевед: переведем
матриц: матрицами
наглядн: наглядно
покажет: покажет
устро: устроены
ячейк: ячейки
замеря: замеряй
ускоря: ускоряй ускоряет
сократ: сократили сократить
вызов: вызова
метод: метода методом метод
блог: блог
сбер: сбер
высок: высокая
производительн: производительность производительности производительностью
тестирован: тестирование
сист: систем
ретроспектив: ретроспектива
привет: привет
замер: замер замера
сам: самое самых самые
упражнен: упражнение
разработчик: разработчика разработчик разработчиков разработчики
приход: приходится приходом
реша: решать
куч: кучу
разбира: разбираться
создава: создавать
правильн: правильные правильную
услов: условия
вс: вс
равн: равно
получ: получить получится
погрешн: погрешностью
люб: любой любого
бесплатн: бесплатный
треб: требует
ресурс: ресурсов
процессор: процессора
александр: александр
певненк: певненко
сбертех: сбертехе
вмест: вместе вместо
команд: командой команда команды команд
развива: развиваем
облачн: облачный
сервис: сервис
упроща: упрощает
приложен: приложений приложение
использу: используя
концепц: концепцию
хранен: хранения
управлен: управления
расскаж: расскажу
способ: способ способов
помощ: помощью помощи
бенчмарк: бенчмарков
рассматрива: рассматривать
пример: примере примеров пример
оптимизац: оптимизации
помогл: помогла
пользова: пользоваться
построен: построения
график: графиков
набор: набором набор
библиотек: библиотек библиотеке библиотеками библиотека библиотеки библиотеку
адаптирова: адаптированы
истор: истории
гол: голый голых
ползун: ползун
женщин: женщинам женщин
телеграф: телеграфе
социальн: социальные
сообществ: сообщества
обзор: обзор
паук: паук
текстов: текстовые текстовых текстовой
строк: строки строках строк
ненормальн: ненормальное
мнен: мнение
песочниц: песочницы песочница
прошл: прошли прошлой
врем: времена
исключительн: исключительно
байтов: байтовыми
поддержк: поддержки поддержка
символ: символов символ символа
национальн: национальных
алфавит: алфавитов
некотор: некоторых некоторые некоторый
случа: случаях
огранич: ограничены
размер: размером
настоя: настоящее
наоборот: наоборот
найт: найти
поддержива: поддерживает
юникод: юникод
обрат: обратили
вниман: внимание
слов: слово словах слов
взят: взято
кавычк: кавычки
винипух: винипух
жжж: жжж
спрост: спроста
появлен: появлением
понят: понятие понятий
стал: стало
однозначн: однозначным
стар: старая старую
проблем: проблемах проблемы проблема
разн: разных
основн: основной основная
смысл: смысл
свод: сводится
призва: призвать
абстрагирова: абстрагироваться
схем: схем схемы
кодирован: кодирования кодирование
доступ: доступом
отдельн: отдельным
байт: байтам
остав: оставить
программист: программистов
возможн: возможность возможно возможности
последовательн: последовательностью последовательно
предотврат: предотвратить
большинств: большинство большинстве
ошибок: ошибок
эр: эры
мар: мар
экономичн: экономичный
парсинг: парсинг
кейс: кейс
функц: функций функцию функции функциям
например: например
альтернативн: альтернативный
формат: формат
регулярн: регулярно
парс: парсите
файл: файлы файл
нужн: нужны
встроен: встроенные встроенный
попроб: попробуйте
рассказыва: рассказываем рассказывали
подробн: подробнее подробно
итак: итак
обработа: обработать
больш: большой
сбо: сбоев
аварийн: аварийного
завершен: завершения
убед: убедиться
использ: используется используются используют
спарс: спарсить
идеал: идеале
заран: заранее
валидн: валидны
имеют: имеют
структур: структуру структурах
объедин: объединить
решен: решения решение решений
хитр: хитрые
прием: приемы
уменьшен: уменьшения
потреблен: потребления
консистентн: консистентность
конкуретн: конкуретной
сред: среде
захлебнут: захлебнуться
точк: точка точке
микросервис: микросервисы
рассказа: рассказал
конкурентн: конкурентной
типов: типовых
котор: которыми которое
сталкива: сталкиваются
реч: речь
пойд: пойд
реализова: реализовать
как: какие
злы: злые
сил: силы
помеша: помешать
сдела: сделать сделан сделал
реш: решил
поэт: поэтому
продолжен: продолжение
одн: одном одним
мест: месте
напомн: напомню
рассчита: рассчитан
очеред: очередь
практическ: практического
опыт: опыта
микросервисн: микросервисной
мног: многие многих
вещ: вещи
объясн: объясню
пальц: пальцах
захочет: захочет захочется
ознаком: ознакомиться
строг: строгими
формулировк: формулировками
сраз: сразу
затронут: затронуты
упрощ: упрощ
нны: нные
ид: идеи
паттерн: паттернов паттерна
ультимативн: ультимативный
источник: источники
знан: знаний знания
учебн: учебный
процесс: процесс
роадмэп: роадмэп
популярн: популярных
мир: мире
статистик: статистика статистики
современ: современного
рынк: рынка
свидетельств: свидетельствует
жела: желаемый
навык: навык навыки
широк: широко
распростран: распространено
различн: различных
сфер: сферах
так: таких такого таким
наук: наука
инженер: инженерия
бизнес: бизнес бизнеса
аналитик: аналитика
состав: составил составить
полн: полную
дорожн: дорожную
карт: карту
прилаг: прилагая
классическ: классических
банковск: банковских
банк: банк банка
открыт: открытие
финанс: финансы
связ: связи
дат: дата
сайентист: сайентисты
ива: иван
кондрак: кондраков
константин: константин
грушин: грушин
позвол: позволило
повыс: повысить
эффективн: эффективность эффективно
проверк: проверке
гипотез: гипотез
успел: успели
знает: знаете
занима: занимается занимает
развит: развитием развитие
пул: пула
принят: принятия
выдач: выдаче
кредитн: кредитных кредитно
продукт: продуктов
гарант: гарантий
мал: малого
наста: настало
поговор: поговорить
постро: построили построить
достаточн: достаточно
точн: точно
подел: поделиться
существен: существенный
вклад: вклад
универсальн: универсального
алгоритм: алгоритма
внес: внес
член: член
подруж: подружить
алис: алису алиса алисы
ленив: ленивый
дава: давайте
попробу: попробуем
соедин: соединить
голосов: голосовой
помощник: помощник
образ: образом
смож: сможем
взаимодействова: взаимодействовать
отвеча: отвечать
ограничен: ограничения
опиш: опишу
стольк: столько
писа: писать
созда: создать
собствен: собственную собственного собственно
нул: нуля
мотивац: мотивация
рамк: рамках
пут: пути
пониман: пониманию понимание
глубок: глубокого
счита: считаю считанные
внутрен: внутренней
важн: важно
начина: начинающего
специалист: специалиста
содерж: содержит
узна: узнал узнаете
над: надеюсь
вводн: вводных
описан: описании
аналог: аналогии
мозг: мозгом
углубл: углубляясь
прощ: проще
описа: описать
математическ: математическую
отобража: отображает
зада: заданный
вход: вход
состо: состоят состоит
след: следующих
компонент: компонентов
пиш: пишем
бот: бота ботов бот
администратор: администратора
тестиру: тестируем
жен: жене жены
создан: создание создания
телегр: телеграм
увлекательн: увлекательных увлекательного
вариант: вариант
добавлен: добавления
проект: проекта проектов проекты
сво: свой
портфол: портфолио
комфорт: комфорта
удобств: удобства
пользовател: пользователей
повседневн: повседневной
жизн: жизни
анализ: анализа
выбра: выбрал
предоставля: предоставляет
богат: богатый
инструмент: инструментов
функциональн: функционально функционального
насыщен: насыщенных
функциона: функционал
защит: защиты
спам: спама
кика: кикать
мут: мутить
получен: получение
рассмотр: рассмотрим рассмотрены
использова: использовал использовать
тестирова: тестировать
рекурс: рекурсия
бесконечн: бесконечные
узор: узоры
самоподобн: самоподобны
масштаб: масштабах
ствол: ствол
дерев: дерева
расщепля: расщепляется
ветк: ветки
распада: распадаются
мелк: мелкие
ветв: ветви
программн: программная
генерац: генерация
преврат: превратит
форм: формы
покаж: покажу
впечатля: впечатляющие
геометр: геометрии
чист: чистила
ударен: ударений
трагед: трагедия
гуманитар: гуманитария
трех: трех
акт: актах
объект: объекты
класс: класса
присваива: присваивать
перемен: переменным
хран: хранить
передава: передавать
аргумент: аргументов
друг: другим
возвраща: возвращать
значен: значений
интуитивн: интуитивное
значительн: значительно
облегч: облегчит
продвинут: продвинутых продвинуться
лямбд: лямбды
декоратор: декораторы
поможет: поможет
техник: техникам
привед: приведу
ряд: ряд
помогут: помогут
разв: развить
послед: последующий
опира: опираться
предыдущ: предыдущий
опробова: опробовать
сесс: сессии
интерпретатор: интерпретатора
ход: ходу
подход: подходы
реализац: реализации
фабрик: фабрика фабрики
проектирован: проектирование проектирования
рефакторинг: рефакторинг
объясня: объяснять
польз: пользу
частност: частности
начин: начиная
банальн: банальных
заканчив: заканчивая
интересн: интересными
вывод: вывод
уровн: уровней уровнях
интерфейс: интерфейсов
командн: командной
настройк: настройка
выполня: выполняйте
скрипт: скрипты скриптов скрипт
написан: написание
используем: используемый
бэкенд: бэкенд
ключ: ключом
модул: модуль
необходим: необходимые
позволя: позволяет
представл: представлены
момент: моменты
погруз: погрузиться
минут: минут минуты
читател: читатели
хоч: хочу
уникальн: уникальными
совет: советами
качествен: качественный
ваш: вашего
стильн: стильный
логотип: логотип логотипов
эпох: эпоху
и: ии
документирован: документирование
станов: становится
игнорир: игнорируют
документац: документации
поскольк: поскольку
актуальн: актуальна
разобра: разобраться
наш: нашего
труд: труда
сто: стоит
учест: учесть
запомн: запомнить
диалог: диалоге
превыс: превысите
лимит: лимиты
потеря: потеряет
контекст: контекст
попрос: попросить
науч: научимся
эконом: экономить
максимальн: максимально
практик: практики
секрет: секреты
студент: студентов
ртсу: ртсу
российск: российско
таджикск: таджикском
славянск: славянском
университет: университете университетом
действ: действует
называ: называемая
бальн: бальная
систем: система
набра: набранных
балл: баллов
доступн: доступно
сюд: сюда
ваканс: вакансий вакансии
аккаунт: аккаунт
войт: войти
регистрац: регистрация
раздел: разделы
публикац: публикации
хаб: хабы
информац: информация
устройств: устройство
сайт: сайта
документ: документы
соглашен: соглашение
конфиденциальн: конфиденциальность
услуг: услуги
корпоративн: корпоративный
медийн: медийная
реклам: реклама
нативн: нативные
образовательн: образовательные
программ: программы
стартап: стартапам
мегапроект: мегапроекты
яндекс: яндекс
дзен: дзен
техническ: техническая
вернут: вернуться
верс: версию
python: python
rss: rss
alexbryl: alexbryl
chatgpt: chatgpt
natur: natural
languag: language
process: processing
openai: openai
gpt: gpt
turbo: turbo
whisper: whisper
telegram: telegram
nstrek: nstrek
gridsearch: gridsearch
progressivegridsearch: progressivegridsearch
ml: ml
open: open
sourc: source
vova: vova
sam: sam
kera: keras
lstm: lstm
tensorflow: tensorflow
c: c
sber: sber
java: java
platform: platform
dataspac: dataspace
backend: backend
servic: a
baa: service
jmh: baas
kotlin: jmh
scala: kotlin
xenon: scala
nudecrawl: xenon
gogalaim: nudecrawler
rust: gogalaim
unicod: rust
import: unicode
level: importance
abstract: level
string: abstract
matt: strings
giuca: matt
honyaki: giuca
msgspec: honyaki
json: msgspec
skillfactori: json
messagepack: skillfactory
mixon: messagepack
transact: mixon
outbox: transactional
saga: outbox
badcasedaili: saga
roadmap: badcasedaily
ivankondrakov: roadmap
peleccom: ivankondrakov
craxti: peleccom
recoveri: craxti
mode: recovery
api: mode
faq: api
telebot: faq
funguist: telebot
rikki: funguistics
tikki: rikki
otu: tikki
eijawa: otus
alexxi: eijawa
linux: alexxis
bash: linux
cli: bash
devop: cli
argpars: devops
denisxab: argparse
readm: denisxab
midjournei: readme
habr: midjourney
await: habr
tdd: awaitable
android: tdd
dmitryspb: android
kesn: dmitryspb
pushtaev: kesn
ru: pushtaev
vd: ru
alizar: vds
grigoryvp: alizar
alrusdi: grigoryvp
scorobei: alrusdi
homm: scorobey
ph: homm
piter: ph
data: piter
scientist: data
django: scientist
facebook: django
twitter: facebook
vk: twitter
youtub: vk
