хабр: хабр хабре
откр: открыть
список: список
стат: стать статья статье статью статей статьи
автор: автором авторы авторов
поток: потоки потоками
разработк: разработка разработкой разработки разработку
администрирован: администрирование администрирования
дизайн: дизайн
менеджмент: менеджмент
маркетинг: маркетинг
научпоп: научпоп
поиск: поиск
профил: профиль
обнов: обновить
рейтинг: рейтинг
альф: альфа альфы альфе
банк: банк банке банка
лучш: лучший лучшие лучшего
мобильн: мобильный мобильных мобильные мобильной мобильном
верс: версии версию
блог: блог
новост: новости
ваканс: вакансии вакансий
подписчик: подписчики
ещ: ещ
сотрудник: сотрудники сотрудника
нов: новые новых новый новую
скопирова: скопировать
ссылк: ссылку
показыва: показывать
примен: применить
час: часов
работа: работают работает работаю
игров: игровые
механик: механики
прочтен: прочтение
мин: мин
количеств: количество количества
просмотр: просмотров
компан: компании компанию компаниях компаний
аналитик: аналитика аналитик аналитиков аналитикам
приложен: приложений приложения приложении
кейс: кейс
вопрос: вопрос вопросы вопросах
зада: задают задали задать
постоя: постоянно
привет: привет
зовут: зовут
тагир: тагир
хайрутдин: хайрутдинов
старш: старший
дан: данных данным данной
прошл: прошлый
посет: посетил
примерн: примерно
профильн: профильных
конференц: конференций конференции
проч: прочих
мероприят: мероприятий мероприятиях
рассказыва: рассказываю рассказывают
люд: людям
геймификац: геймификация
как: какое какие
влиян: влияние
оказыва: оказывает
бизнес: бизнес бизнеса
пример: примере примерах пример
проект: проектов проектах проекты проекте проектами проекта проект
сам: самый самых
част: частый часть
маркетолог: маркетологов маркетологам
овнер: овнеров овнерам
реальн: реально реальными
пойдет: пойдет
реч: речь
расскаж: расскажу
эффект: эффект
получа: получает получается
использу: используем
дела: делать делаете
игр: игры игр
симулятор: симулятор
мошенник: мошенника мошенников
предлага: предлагали
клиент: клиентам клиент
форм: форме
провер: проверить
сво: сво своим своими своему своем
умен: умение
распознава: распознавать
интересн: интересна интересного
продакт: продакт
чита: читать читайте читали
дал: далее
голос: голосов
добав: добавить
закладк: закладки
комментар: комментарии
мар: мар
рендеринг: рендеринг рендеринга
уровен: уровень
сложност: сложности
прост: простой простого простым
веб: веб
сайт: сайтов сайта сайт
туториа: туториал
хаджимурад: хаджимурад
занима: занимаюсь
фронтенд: фронтенд
успел: успел
поработа: поработать
мног: многих
интернет: интернет
магазин: магазин
панел: панели
университет: университета
хоч: хочу
подел: поделится поделюсь поделиться поделились
опыт: опытом
постара: постараюсь
описа: описать
способ: способа способы
раскр: раскрыть
плюс: плюсы
минус: минусы
практическ: практических практически практические
провест: провести
сравнен: сравнение
производительн: производительности
размер: размеров размер
материа: материал
подойд: подойд
начина: начинающим начинал начинающий начинающих
разработчик: разработчикам разработчиков разработчик
хочет: хочет
познаком: познакомиться
пониман: понимания
потреб: потребуются
начальн: начальные
знан: знания
менеджер: менеджеров
пакет: пакетов
вид: видите видишь виде видов
тестирован: тестировании тестирование тестирования тестированию
сист: систем
ретроспектив: ретроспектива
смог: смог
правильн: правильно
ответ: ответить ответил ответы ответа ответ
ручн: ручного
департамент: департаментом
раскатыва: раскатываем
гигантск: гигантский
дашборд: дашборд
привяза: привязан
буквальн: буквально
ко: ко
позволя: позволяет
оцен: оценить
качеств: качество качества
работ: работы работу работе
люб: любой любим любом
команд: команды команд команду командами
ива: иван
боклач: боклач
руководител: руководитель руководителя
направлен: направления
развит: развития развитием
экспертиз: экспертизы
центр: центре
координац: координации
повышен: повышении
эффективн: эффективности
технолог: технологий технологии
метрик: метриками
стандартизац: стандартизацией
автоматизац: автоматизацией
процесс: процессов
вс: вс
пиш: пишу
хвастовств: хвастовства
отнюд: отнюдь
показа: показать показаться
привест: привести
дорожк: дорожка дорожке
главн: главное главных
крафт: крафтить
получ: получить получил получилось
результат: результаты
меня: менять
стресс: стресса стресс
ид: ид идеи
гост: гости
прелогин: прелогин
средн: средний
управлен: управление
персонал: персоналом
заход: заходит
айтишник: айтишник
поскролл: поскроллил
рекрутер: рекрутеру
оффер: оффер
переписк: переписке
почт: почту
мессенджер: мессенджере
собеседован: собеседований собеседования собеседованиях собеседование собеседовании
сомнен: сомнения
удобн: удобно удобным
пингова: пинговать
десятк: десятки
сообщен: сообщений
виж: вижу
найм: найм
понятн: понятный
встав: вставая
дива: дивана
сдела: сделать сделали
лежат: лежат
бэклог: бэклоге
наш: нашей наших
разрабатыва: разрабатываете
продукт: продукты
нанима: нанимаете нанимающая
бол: болью
проход: проходите проходило проходил
ошиба: ошибаемся
первоначальн: первоначальной первоначальная
оценк: оценке оценка
фич: фич
анализ: анализ
проектирован: проектирование
подготовк: подготовка
техническ: технической техническая
документац: документации
участв: участвую
расход: расходится
срок: сроками сроки
внедр: внедрили
скрам: скрам
планирован: планирование
ежедневн: ежедневные
летучк: летучки
грумминг: грумминг
внутр: внутри
налад: наладили
коммуникац: коммуникацию
равн: равно
раз: разом
отодвига: отодвигаются
возника: возникает
закономерн: закономерный
микросервис: микросервисы
обзор: обзор
реш: решили решил
вод: воды
картинок: картинок
поня: понять понял
дел: деле дело
должн: должны
практик: практикой практики практике
копипаст: копипастой
разн: разных разные разными разным
книг: книг книгу книга книги
котор: которую которое
друг: друг другу другую
опытн: опытных
архитектор: архитекторов архитектор
хот: хотят хотим
максимальн: максимально
претенд: претендует
хорош: хороший
стил: стиль
написан: написания
код: кода код кодом
запуст: запустить
облада: обладать
вообщ: вообще
никак: никаким никакие
ит: ит
бэкграунд: бэкграундом
настраива: настраивать
приступ: приступим
фев: фев
игра: играли
тест: тесты тест
проигра: проиграли
начал: начале
дорог: дорогой
читател: читатель
писа: писал
андроид: андроид
вероятн: вероятность
крайн: крайне
мал: мала
так: таким таки
сталкива: сталкивался
пришел: пришел
небольш: небольшой
дисклеймер: дисклеймер
непонятн: непонятным непонятно
дава: давай
представ: представим
приход: приходишь приходится приходил
картинк: картинке
множествен: множественные
личност: личности
машин: машинное машинного
обучен: обучение обучения
искусствен: искусственный
интеллект: интеллект
нача: началась начать
отправк: отправки
письм: письма
коллег: коллегам коллеги
мо: моих мо мою
эксперимент: экспериментах
момент: момент
объемн: объемным
рук: руках
готов: готовая
размещен: размещения
некотор: некоторыми некоторых
хинт: хинтами
трик: триками
шум: шума
продемонстрирова: продемонстрировать
создан: создание создания
субличн: субличностей субличности
возможн: возможно
полезн: полезны полезной полезна
науч: научимся
создава: создавать
посмотр: посмотрим
различа: различаются
увид: увидите
помоч: помочь
расшир: расширить
реакц: реакции
событ: события
выд: выда
плох: плохой
изощрен: изощренный
спрос: спросим
смысл: смысле смысла
быт: бытия
атак: атакует
кратк: краткий
уязвим: уязвимостей уязвимости
информацион: информационная
безопасн: безопасность безопасности
программирован: программирование
браузер: браузеры браузере
рассказа: рассказать
быва: бывают
откуд: откуда
ждат: ждать
сраз: сразу
предназнач: предназначена
скор: скорее скоро
новичк: новичков
тем: теме тему тема
уникальн: уникальность
глубок: глубокое глубоких
погружен: погружение
последн: последнее
фронт: фронта фронтами
систем: системы система системе системам
авторизац: авторизации
аутентификац: аутентификации
пользовател: пользователей пользователи
уделя: уделять
компрометац: компрометации
авторизацион: авторизационных
поэт: поэтому
собра: собрать собрали собрала
оп: опыт
област: области
куч: кучу
актуальн: актуальной
тк: тк
кажд: каждую каждой
недел: неделю
слыш: слышим
истор: истории историями
утечк: утечках
крупн: крупных крупном
прогрессивн: прогрессивных
российск: российских
заня: занял
мест: место места местах месте
участник: участников
спортивн: спортивное
карьер: карьера
индустр: индустрии
олег: олег
сидоршин: сидоршин
стажер: стажер
март: марта
джун: джуном
лаборатор: лаборатории
переход: перехода переход
коммерческ: коммерческую
навык: навыков
активн: активно
участвова: участвовал
соревнован: соревнованиях соревновании
пост: пост
компьютерн: компьютерному
зрен: зрению зрения
сража: сражался
одн: одном одна одно
уровн: уровне
холодильник: холодильниками
помогл: помогло
переж: пережить
полет: полет
совет: советах
урок: уроках
улучшен: улучшения
ваш: ваших вашего
рабоч: рабочей
бюджет: бюджета
арт: арт
терап: терапия
вялотекущ: вялотекущая
миграц: миграция
монолит: монолита
пришл: пришла
сказа: сказали
пройд: пройд
ближайш: ближайшее
оста: осталось
разобра: разобраться
огромн: огромная огромного
инфраструктур: инфраструктура
множеств: множество
интеграц: интеграций
разнородн: разнородные
всевозможн: всевозможных
масштаб: масштабов
требован: требованиями требования
целев: целевые
стратег: стратегии стратегия
задач: задачи задача
лин: линия
поддержк: поддержки поддержка
учет: учета
изменен: изменений изменение
законодательств: законодательства
соблюден: соблюдения
стандарт: стандартов
современ: современные
стремительн: стремительное
миров: мировой
ситуац: ситуации
окружа: окружает
ч: ч
сложн: сложно сложная сложный
структур: структуру
найт: найти
един: единый
документ: документ документы
увидет: увидеть
схем: схему
ввид: ввиду
нехватк: нехватки
информац: информации информация
ощущен: ощущение
безысходн: безысходности
невозможн: невозможности
верност: верность
решен: решения решений
точк: точки
проектируем: проектируемой
наход: находить находятся
распутыван: распутывания
текущ: текущего текущую
положен: положения
каза: казалось
жит: жить
намерен: намеренно
запутыва: запутывает
стремлен: стремление
им: имею
подсвет: подсветить
подводн: подводные
камн: камни
риск: риски
привел: привело
замешательств: замешательство
черт: черта
понима: понимаю понимаете
происход: происходит
треб: требует
нестандартн: нестандартных
янв: янв
митап: митапе митап
шата: шатали
декабр: декабря
провел: провели
отказоустойчив: отказоустойчивости
вес: вес
лым: лыми
паден: падения падений
убытк: убытки
поговор: поговорили
смягча: смягчать
последств: последствия
сэконом: сэкономить
перееха: переехав
бд: бд
прям: прямом
эфир: эфире
пыта: пытались
слома: сломать
прийт: прийти
прикладыва: прикладываем
запис: записи
доклад: докладов доклад
фотоотч: фотоотч
традиц: традиции
принима: принимай
позиц: позицию позиция
четыр: четыр
х: х
месяц: месяцев месяц
ма: мая
сентябр: сентябрь сентября
будущ: будущего
задава: задавал задавать
подход: подходит
итог: итоге
удовлетвор: удовлетворили
соглас: согласился согласуются
предложен: предложение предложений
распростра: распростран
нны: нный
затягива: затягиваются
увлекательн: увлекательного
квест: квеста
проверк: проверки проверку
хард: хард
софт: софт
скилл: скиллов
попаст: попасть
отклик: отклик
гарантир: гарантирует
приглашен: приглашение
интерв: интервью
формальн: формального
заявк: заявку заявка заявки
жела: желающих
порядк: порядка
уч: уч
работодател: работодателей работодателя
сторон: сторона
рынк: рынке
провод: проводит
тщательн: тщательный
отбор: отбор
сожален: сожалению
дат: дата
сайентист: сайентист
поступа: поступать
аналогичн: аналогичным
образ: образом
прособеседова: прособеседовать
интерес: интересующие
самостоятельн: самостоятельно
сет: сети
ключев: ключевых
желательн: желательно
трудоустройств: трудоустройства
зависет: зависеть
провед: провед
иска: искать
пойм: пойм
перечислен: перечислением
огранич: ограничусь
попыта: попытаюсь
донест: донести
счита: считаю считаться
важн: важными
капот: капотом
сможет: сможете
узна: узнать
придержива: придерживались
подруж: подружить
сохран: сохранив
ментальн: ментальное
здоров: здоровье
сообществ: сообществом
контент: контент
лид: лид
отдел: отдела
стран: странным
запрос: запросом
управля: управлять
ожидан: ожиданиями
помощ: помощью
фреймворк: фреймворка
деврел: деврелов
дек: дек
подборк: подборка подборки
материал: материалов
профессиональн: профессиональная
литератур: литература
алгоритм: алгоритмы
инструмент: инструменты инструмент
популярн: популярное
чтив: чтиво
почита: почитать
новогодн: новогодние
выходн: выходные
весел: веселые весело
легас: легаси
динамическ: динамические
микрофронт: микрофронты
рефакторинг: рефакторинг
технотекст: технотекст
прекрас: прекрасен
больш: большой большая
разнообразн: разнообразный
дума: думаю
ник: никого
удив: удивил
ландшафт: ландшафт
содерж: содержит
велик: великое
всяк: всякой
флор: флоры
фаун: фауны
необходим: необходимо
джунгл: джунглей
улыба: улыбаются
игрив: игриво
подмигива: подмигивают
орд: орды
живет: живет
собствен: собственной
жизн: жизнью
поддержива: поддерживается
например: например
написа: написанными
документооборот: документооборота
пр: пр
организац: организации
упорядочиван: упорядочивания
различн: различных
бюрократическ: бюрократических
процедур: процедур
электрон: электронная
задумк: задумке
долж: должен
открыва: открываешь
сервис: сервис сервиса
выбира: выбираешь
тип: тип
заполня: заполняешь
отправля: отправляешь
нюанс: нюанс
заявок: заявок
родительск: родительской
созда: создаются
инструментар: инструментарием
страда: страдают
ужаса: ужасаются
окуна: окунаются
зоопарк: зоопарк
бежа: бежать
нажима: нажимать
кругляк: кругляков
клиентск: клиентского
пут: пути
объединя: объединяет
беготн: беготни
нордическ: нордически
выдержив: выдерживая
приятн: приятно
грех: греха
та: таить
втор: вторая
специалист: специалистов
кат: катом
квалификацион: квалификационные
пособ: пособия пособие
классик: классика
рома: романа роман
савин: савина
читальн: читальный
зал: зал
предвзят: предвзято
относ: относимся
роман: роману
наоборот: наоборот
дот: дот
хотел: хотели
аж: аж
ручк: ручки
чеса: чесались
наверняк: наверняка
слыша: слышали
очередн: очередной
пересказыва: пересказывать
руководств: руководства
справочник: справочники
кт: кт
ресурс: ресурсов
тренировок: тренировок
начн: начн
институтск: институтского
курс: курса курс
подкаст: подкасты
теор: теории
стэнфордск: стэнфордский
рекомендац: рекомендаций рекомендациям
изучен: изучения
ов: ов
коротк: короткая
шпаргалк: шпаргалка
анастас: анастасия
пласкевич: пласкевич
разбира: разбиралась
зависим: зависимостями зависимостей
углуб: углубилась
реша: решать
проблем: проблемы
базов: базовую базовый
адаптирова: адаптировали
столкнул: столкнулись
некорректн: некорректным
поведен: поведением
стар: старым старую
ауд: аудит
умест: уместен
вещ: вещи
поправ: поправить
сюд: сюда
регистрац: регистрации регистрация
основан: основания
числен: численность
свыш: свыше
местоположен: местоположение
росс: россия
представител: представитель
аккаунт: аккаунт
войт: войти
раздел: разделы
хаб: хабы
песочниц: песочница
устройств: устройство
соглашен: соглашение
конфиденциальн: конфиденциальность
услуг: услуги
корпоративн: корпоративный
медийн: медийная
реклам: реклама
нативн: нативные
образовательн: образовательные
программ: программы
стартап: стартапам
спецпроект: спецпроекты
яндекс: яндекс
дзен: дзен
настройк: настройка
язык: языка
вернут: вернуться
markswebb: markswebb
rss: rss
tagir: tagir
analyz: analyzes
data: data
mine: mining
big: big
khidirbekov: khidirbekov
csr: csr
ssg: ssg
ssr: ssr
javascript: javascript
html: html
reactj: reactjs
c: c
react: react
npm: npm
yarn: yarn
ivanboklach: ivanboklach
qa: qa
sardok: sardok
linkedin: linkedin
roadmap: roadmap
hr: hr
tech: tech
alaeva: alaeva
t: t
refresh: refresh
python: python
id: ide
ab: ab
cha: cha
groovi: groovy
android: android
kotlin: kotlin
unit: unit
xsevenbeta: xsevenbeta
chatgpt: chatgpt
dunai: dunai
xss: xss
oasidorshin: oasidorshin
kaggl: kaggle
competit: competition
master: master
petfind: petfinder
pawpular: pawpularity
predict: prediction
nvidia: nvidia
ml: ml
igulg: igulg
alfateam: alfateam
java: java
alfa: alfa
backend: backend
stori: stories
smirnovevgeni: smirnovevgeny
scienc: science
head: head
machin: machine
learn: learning
laboratori: laboratory
m: m
khailpopov: khailpopov
devrel: devrel
kotpilun: kotpilun
inbox: inbox
kubernet: kubernetes
enterpris: enterprise
sap: sap
hcm: hcm
ui: ui
fiori: fiori
erp: erp
ibm: ibm
lotu: lotus
note: notes
peopl: people
engin: engineering
scientist: scientist
plastya: plastya
flomast: flomaster
lockfil: lockfile
node: node
js: js
lock: lock
ts: ts
digit: digital
alfabank: alfabank
ru: ru
nikitina: nikitina
sd: sd
facebook: facebook
twitter: twitter
vk: vk
telegram: telegram
youtub: youtube
habr: habr
