хабр: хабр
откр: открыть
список: список
стат: стать разделы
автор: автором компании сайта
поток: потоки
разработк: разработка
администрирован: администрирование
дизайн: дизайн
менеджмент: менеджмент
маркетинг: маркетинг
научпоп: научпоп
поиск: поиск
профил: профиль
обнов: обновить
минут: минут
выражен: выражение
числ: числа число
вид: виде
букв: букв буквы вернем рассчитываем
уровен: уровень
сложност: сложности
средн: средний
прочтен: прочтение
мин: мин
количеств: количество
просмотр: просмотров
программирован: программирование
игр: игр игры игре
песочниц: песочницы авторы
разрабатыв: разрабатывая
сталкива: сталкиваются
выраз: выразить
сокращен: сокращенную
форм: форму
использ: используются
маленьк: маленькие
знак: знаков
принцип: принципе
выража: выражать
существ: существующем существует
пример: примера
проект: проекте нативные
созд: создам
отображен: отображение отображения
монет: монет монетам
кнопк: кнопку
умножа: умножать умножается
нек: некое
значен: значение значений очередным
добавл: добавлю
скрипт: скрипт
брат: брать
текстов: текстового
пол: поля поле
класс: класс
имеет: имеет
свойств: свойства
ссылк: ссылка
множител: множитель множителя
отображ: отображены
сериализуем: сериализуемое
метод: метод
имеющ: имеющееся
записыва: записывать
получен: полученное
нажим: нажимая
момент: момент
станов: становится
больш: большим представление
неудобн: неудобным
чтен: чтения
способ: способ
котор: которым которыми переменную
сократ: сократить
зап: запись
экспоненциальн: экспоненциальную
вывод: вывода выводить делится детальности
ещ: ещ
одн: одно
внес: внесу
небольш: небольшое
изменен: изменение
код: код коду
так: таким
образ: образом
выводим: выводимое
выглядет: выглядеть
цел: целом
уменьш: уменьшилось
рассмотр: рассмотрим
информац: информации песочница
заменя: заменять заменяем разряды
назначен: назначение
дал: далее
област: область
выгляд: выглядит
итогов: итоговый
поясн: поясню
масс: массив
сообща: сообщает
определен: определенном
диапазон: диапазоне диапазон
чисел: чисел
перв: первом
втор: втором
комбинац: комбинации
трет: третьем
предыдущ: предыдущий делим
цифр: цифры буквами
хран: храним
массив: массива
счита: считаем
длин: длину
смысл: смысла
либ: ним
дела: либо
верн: делать
высш: цифр
разряд: высшие значением данном
соответствен: заменяются
дел: соответственно разряде
преобразова: выводится которую
общ: преобразовать
исключен: общее
лидир: исключением
делен: лидирующих
преобразовыва: деленное сравниваем начинаем
тыщ: преобразовываем
дан: тыщи букву
сравнива: данных
очередн: преобразовываемых
созда: разрядов
перемен: создаем
подсчет: преобразованные
групп: подсчета
начина: группы
проход: преобразовывать
кажд: проходим
уровн: каждому предыдущего
рассчитыва: уровню
степен: уровня
текущ: степени индекс
получ: текущего
индекс: получив
дописыва: текущей
строков: дописываем
представлен: строковое
детальн: большей
десят: выводим
дол: десятую
наш: долю
возвраща: нашего
собствен: возвращаем
вариант: собственно
доклад: вариант
законч: доклад
тег: закончил
преобразован: теги
хаб: преобразования
рейтинг: хабы
добав: рейтинг
закладк: добавить
комментар: закладки
карм: комментарии
серг: карма
пользовател: сергей
публикац: пользователь
лучш: публикации
сутк: лучшие
похож: сутки
истор: похожие
работ: истории
разработчик: работа
ваканс: разработчик удаленно
программист: вакансий
удален: программист
аккаунт: вакансии
войт: аккаунт
регистрац: войти
раздел: регистрация
новост: статьи
компан: новости авторов
устройств: информация
сайт: устройство
документ: компаний
соглашен: документы
конфиденциальн: соглашение
услуг: конфиденциальность
корпоративн: услуги
блог: корпоративный
медийн: блог
реклам: медийная
нативн: реклама
образовательн: проекты
программ: образовательные
стартап: программы
спецпроект: стартапам
яндекс: спецпроекты
дзен: яндекс
настройк: дзен
язык: настройка
техническ: языка
поддержк: техническая
вернут: поддержка
стар: вернуться
верс: старую
xoiox: xoiox
c: c
uniti: unity
idl: idle
system: system
numer: numerics
unityengin: unityengine
ui: ui
public: public
class: class
mlmon: mlmon
monobehaviour: monobehaviour
biginteg: biginteger
monei: money
serializefield: serializefield
gameobject: gameobject
textmonei: textmoney
int: int
multipli: multiplier
void: void
buttonclick: buttonclick
getcompon: getcomponent
text: text
tostr: tostring
textmoney: textmoneye
e: e
b: b
xx: xx
textmoneyabc: textmoneyabc
abc: abc
arraycountdigit: arraycountdigit
char: char
lit: lit
d: a
f: d
g: f
h: g
i: h
j: i
l: j
m: l
n: m
o: n
p: o
q: p
r: q
s: r
t: s
u: t
w: u
x: w
y: x
z: y
string: z
bistr: string
lengthnumb: bistr
length: lengthnumb
countlidernumb: length
countnumberfortransform: countlidernumber
nameliterisnmb: countnumberfortransformation
byte: nameliterisnmber
level: byte
break: level
del: break
currentindex: del
math: currentindex
ceil: math
pow: ceiling
number: pow
substr: number
insert: substring
return: insert
aa: return
ab: aa
ac: ab
az: ac
ba: az
bb: ba
zz: bb
aaa: zz
aab: aaa
aac: aab
zzz: aac
facebook: zzz
twitter: facebook
vk: twitter
telegram: vk
youtub: telegram
habr: youtube
