хабр: хабр хабру
откр: открыть
список: список
стат: стать статьи статье
автор: автором авторы авторов
поток: потоки
разработк: разработка
администрирован: администрирование
дизайн: дизайн
менеджмент: менеджмент
маркетинг: маркетинг
научпоп: научпоп
поиск: поиск
профил: профиль
обнов: обновить
новост: новости
хаб: хабы
компан: компании компания компанию компаний
подряд: подряд
скопирова: скопировать
ссылк: ссылку
показыва: показывать
нов: новые новый новых
лучш: лучшие
порог: порог
рейтинг: рейтинга рейтинг
примен: применить
минут: минуту
времен: временно
отключ: отключила отключили
сервис: сервис сервисы сервису сервиса сервисе сервисов
пользовател: пользователей пользователь пользователем пользователям пользователи
итал: италии
прочтен: прочтение
мин: мин
количеств: количество
просмотр: просмотров
информацион: информационная
безопасн: безопасность
искусствен: искусственный
интеллект: интеллект
облачн: облачные
социальн: социальные
сет: сети
сообществ: сообщества
март: марта
разработчик: разработчики разработчиков
доступ: доступ
сдела: сделала
блокировк: блокировку
геолокац: геолокации
требован: требованию
итальянск: итальянского итальянский итальянское
агентств: агентство
защ: защите
персональн: персональных
дан: данных дано данные
регулятор: регулятор
выяв: выявил
работ: работе работы
нарушен: нарушения нарушениях
сбор: сборе сбор
заяв: заявил заявило
правов: правовой
основ: основы
оправдыва: оправдывающей
массов: массовый
хранен: хранение
чита: читать
добав: добавить
закладк: закладки
комментар: комментарии
истор: истории историю
час: часов часами
опубликова: опубликовала
част: часть
исходн: исходного исходным
код: кода код кодом
включ: включая
рекомендательн: рекомендательного
алгоритм: алгоритма
программирован: программирование
вылож: выложила
открыт: открытый
репозитор: репозитория репозиториев
голос: голосов
науч: научил
генерирова: генерировать
ключ: ключи
активац: активации
ос: ос
стар: старое старого старую
желез: железо
ник: ником
чат: чат
бот: бота
минцифр: минцифры
удален: удаление удаления
аккаунт: аккаунта аккаунт
госуслуг: госуслугах госуслуги госуслуг
явля: является
уклонен: уклонением
служб: службы службе
арм: армии
управлен: управление управления
персонал: персоналом
карьер: карьера
индустр: индустрии
вечер: вечером
сообщ: сообщило
истин: истинную
причин: причину
отключен: отключения
возможн: возможности возможно возможность
ведомств: ведомство
поясн: пояснило
портал: портале
техподдержк: техподдержка техподдержке
кнопк: кнопка
уч: уч
тно: тной
запис: записи
личн: личном
кабинет: кабинете кабинета
скрыт: скрыта
подтверд: подтвердила подтвердили
рф: рф
китайц: китайцы
собира: собираются собирается
постро: построить
крупн: крупнейший крупный крупнейших
подводн: подводный
детектор: детектор детектора
нейтрин: нейтрино нейтринный
куб: куб
км: км
научн: научно
популярн: популярное
астроном: астрономия астрономы
установк: установка установки
средиземн: средиземном средиземного
мор: море моря
глаз: глазами
художник: художника
китайск: китайские китайская китайскими
ны: ные
надеют: надеются
ближайш: ближайшие
телескоп: телескоп
ищут: ищут
маленьк: маленькие
безмассов: безмассовые
частиц: частицы
пронос: проносятся
вселен: вселенную
скорост: скоростью скорости
близк: близкой
свет: света
изуча: изучают
х: х
год: годов
обнаружен: обнаружением
работа: работает работать работаете
цел: целый цель целом
ряд: ряд
интересн: интересных интересные
обсерватор: обсерваторий
изображен: изображение
антарктид: антарктиде
использ: использующего
кубическ: кубический
километр: километр
льда: льда
южн: южном
полюс: полюсе
качеств: качестве
коллектор: коллектора
назван: названием название
разрабатыва: разрабатывается
глубок: глубоко
поверхн: поверхностью
реша: решайте
задач: задачи
выигрыва: выигрывайте
приз: призы призов
блог: блог блоги
хакатон: хакатоны
привет: привет
скор: скоро
пройдет: пройдет
соревнован: соревнование
опытн: опытных
аналитик: аналитиков
трек: треков
нестандартн: нестандартные
рассказыва: рассказываем
ждет: ждет
участник: участников
пода: подать
заявк: заявку
подробн: подробнее
запрет: запретил
нача: начал
расследован: расследование расследования
отношен: отношении
законодательств: законодательство
начал: начале
обвин: обвинил
дал: далее
нашл: нашли
блицар: блицар
радиотелескоп: радиотелескоп
проанализирова: проанализировав
собра: собранные собрали
исследовател: исследователи
предполож: предположили
обнаруж: обнаружили обнаружил
редк: редкое
астрономическ: астрономическое
событ: событие
внезапн: внезапный
коллапс: коллапс коллапса
массивн: массивной массивная массивных
нейтрон: нейтронной нейтронных нейтронная нейтроны
звезд: звезды звезда звезде
привест: привести
например: например
слиян: слияние
зв: зв
зд: зд
результат: результате
образ: образуется
нестабильн: нестабильная
котор: которую которое
удержива: удерживает
немедлен: немедленного
быстр: быстрое
вращен: вращение
наскольк: насколько
больш: большой большого
прежд: прежде
рухнет: рухнет
ч: ч
рну: рную
дыр: дыру дыра
точн: точного
ответ: ответа
вопрос: вопрос вопросы
отчаст: отчасти
конц: конца
понима: понимаем
происход: происходит
матер: материей
внутр: внутри
объект: объектов
зна: знаем
выжива: выживают
давш: давшие
распада: распадаются
составля: составляющие
кварк: кварки
илон: илон
маск: маск маска
планир: планирует
виз: визит
кита: китай
владелец: владелец
хочет: хочет
встрет: встретиться
премьер: премьер
министр: министром
кнр: кнр
транспорт: транспорт
апрел: апреле апреля
главн: главная
встреч: встреча
кит: китая
цян: цяном
пыта: пытается
организова: организовать
команд: команда
предположен: предположения
перв: первую первом
очеред: очередь
связа: связан
бизнес: бизнесом
счита: считается
втор: вторым
величин: величине
рынк: рынком
сша: сша
завод: завод
шанха: шанхае
производствен: производственный
центр: центр
интерес: интересы
станов: становится
одн: одним
источник: источников
доход: доходов
соцсет: соцсети
предел: пределами
стал: стала
недоступн: недоступна
функц: функция
чист: чистая чистой
прибыл: прибыль
упа: упала
производств: производство
электроник: электроники электроника
финанс: финансы
отчита: отчиталась
десятилет: десятилетие
паден: падении
приб: прибыли
состав: составило
млрд: млрд
санкц: санкции
производител: производителя
телекоммуникацион: телекоммуникационного
оборудован: оборудования
практическ: практически практический
уничтож: уничтожили
подразделен: подразделение
выпуск: выпуску
смартфон: смартфонов
вынуд: вынудили
фирм: фирму
нараст: нарастить
расход: расходы
исследован: исследования
блокирова: блокировать
продавц: продавцов продавцами
поддельн: поддельных
видеокарт: видеокарт видеокарты
компьютерн: компьютерное компьютерных
борот: бороться
сотруднича: сотрудничает
маркетплейс: маркетплейсами маркетплейса
контрафактн: контрафактную
продукц: продукцию
снима: снимали
продаж: продажи
переезд: переезд переезда
реклам: рекламу реклама
измен: изменилось
лид: лид
форм: формах формы
интернет: интернет
контекстн: контекстная
повышен: повышение
конверс: конверсии
претерпел: претерпели
перерожден: перерождение
рекламн: рекламного
вконтакт: вконтакте
разбер: разберемся
обновлен: обновлениями
запуст: запустил
курс: курс
студент: студентов студентам студенты студентом
вшэ: вшэ
учебн: учебный
процесс: процесс
подготов: подготовили
бакалаврск: бакалаврских
программ: программ программу программе программы
факультет: факультета
наук: наук науке
ни: ниу
классическ: классической
трехзвен: трехзвенной
архитектур: архитектуры
курсов: курсовом
проект: проекте проекта проектах проекты
эксперт: эксперты
дадут: дадут
актуальн: актуальные
прикладн: прикладные
знан: знания
оп: опыт
инфраструктур: инфраструктурой инфраструктуру инфраструктура
уча: учащиеся
писа: писать
микросервис: микросервисы микросервисов
настро: настроив
изучат: изучат
различн: различные
вид: виды
архитектурн: архитектурных архитектурные
диаграмм: диаграмм диаграммы
развернут: развернут
тестов: тестовых
стенд: стендах
итог: итогам
получат: получат
групп: группу
манифест: манифесты
развертыван: развертывания
доск: доску
виджет: виджетами
продемонстрирова: продемонстрировать
предостав: предоставит
вычислительн: вычислительные
мощност: мощности
платформен: платформенных
кластер: кластерами
баз: базами
кажд: каждым
индивидуальн: индивидуально
дава: давать
материал: материалы
изучен: изучение
отвеча: отвечать
курирова: курировать
особ: особо
отлич: отличившихся
приглас: пригласим
стажировк: стажировку
мтс: мтс
яндекс: яндекс
маркет: маркет маркета маркете
пользовательск: пользовательскую
реферальн: реферальную реферальной
привлечен: привлечения
появ: появилась
рекомендова: рекомендовать
ран: ранее раннюю ранняя
доступн: доступной
магазин: магазинов
торг: торгующих торгующие
участвова: участвовать
люб: любые
физическ: физические
юридическ: юридические
лиц: лица
числ: числе
ип: ип
рассказа: рассказали
пресс: пресс
джеймс: джеймс
уэбб: уэбб уэббом
сам: самую самая
известн: известную известная
космическ: космический
существова: существовавшую
млн: млн
взрыв: взрыва
рна: рная
ным: ным
имел: имела
масс: массу
солнечн: солнечных
момент: моменте
запечатл: запечатл
нном: нном
продолжа: продолжала
сво: свой
рост: рост
гостев: гостевая
лекц: лекция лекцию
розыгрыш: розыгрыш
эксклюзивъ: эксклюзивъ
вашихъ: вашихъ
экранахъ: экранахъ
след: следующий
четверг: четверг
провед: проведем
андре: андреем
аксенов: аксеновым
подкаст: подкастов подкасте
закат: закат
импер: империи
деньг: деньги
регистрир: регистрируйтесь
услыша: услышать
эксклюзивн: эксклюзивную
зада: задать
пообща: пообщаться
режим: режиме
реальн: реального
важн: важном
необходим: необходимом необходимо
основа: основаны основан
конспект: конспектах
алексе: алексея
барабанов: барабанова
директор: директора
хлебниц: хлебницы
админ: админов
русскоязычн: русскоязычного
алекс: алексей
спикер: спикером
наш: нашего
практикум: практикума практикум
опыт: опыте
разн: разных
поэт: поэтому
базир: базируется
теор: теории
узна: узнать
практик: практикой
ювелир: ювелир
аризон: аризоны
предлага: предлагает
анодирова: анодированном
титанов: титановом
корпус: корпусе
позолочен: позолоченным позолоченный
ремешк: ремешком
гаджет: гаджеты
носим: носимая
кастомн: кастомную
модел: модель
син: синего
цвет: цвета цвете
кол: кол
сик: сико
выполн: выполнено
золот: золотом
сохранен: сохранением
оранжев: оранжевой
полоск: полоски
комплект: комплекте
поставля: поставляется
ремешок: ремешок
сюд: сюда
гк: гк
лан: ланит
войт: войти
регистрац: регистрация
раздел: разделы
публикац: публикации
песочниц: песочница
информац: информация
устройств: устройство
сайт: сайта
документ: документы
соглашен: соглашение
конфиденциальн: конфиденциальность
услуг: услуги
корпоративн: корпоративный
медийн: медийная
нативн: нативные
образовательн: образовательные
стартап: стартапам
мегапроект: мегапроекты
дзен: дзен
настройк: настройка
язык: языка
техническ: техническая
поддержк: поддержка
вернут: вернуться
верс: версию
rss: rss
deni: denis
openai: openai
chatgpt: chatgpt
twitter: twitter
github: github
python: python
java: java
scala: scala
main: main
repo: repo
ml: ml
window: windows
enderman: enderman
sly: sly
g: g
km: km
net: net
icecub: icecube
melindat: melindat
s: s
tinkoff: tinkoff
solut: solution
cup: cup
anniebronson: anniebronson
chime: chime
markati: markaty
tesla: tesla
travi: travis
macrif: macrif
huawei: huawei
nvidia: nvidia
geforc: geforce
clickru: clickru
vk: vk
click: click
ru: ru
cloudmt: cloudmts
devop: devops
infrastructur: infrastructure
code: code
kubernet: kubernetes
gitlab: gitlab
grafana: grafana
containerum: containerum
dbaa: dbaas
postgresql: postgresql
ancotir: ancotir
e: e
commerc: commerce
andreyzaytsev: andreyzaytsev
selectel: selectel
hedgehog: hedgehog
art: art
rabbitmq: rabbitmq
southbridg: southbridge
appl: apple
watch: watch
ultra: ultra
de: de
billa: billas
lux: lux
digit: digital
crown: crown
ruvd: ruvds
timeweb: timeweb
cloud: cloud
otu: otus
open: open
data: data
scienc: science
getmatch: getmatch
firstvd: firstvds
facebook: facebook
telegram: telegram
youtub: youtube
habr: habr
