хабр: хабр хабре хабра
откр: открыть открыл
список: список
стат: стать статьи статье статью
автор: автором авторы авторов
поток: потоки потока потоков
разработк: разработка разработки разработкой разработке разработку
администрирован: администрирование
дизайн: дизайн
менеджмент: менеджмент менеджмента
маркетинг: маркетинг
научпоп: научпоп
поиск: поиск поиске
профил: профиль
обнов: обновить
новост: новости новостей новостями
хаб: хабы
компан: компании компаний компания
подряд: подряд
скопирова: скопировать
ссылк: ссылку
показыва: показывать показывают
нов: новые новый новых новое новыми новым новую
лучш: лучшие
порог: порог
рейтинг: рейтинга рейтинг
уровен: уровень
сложност: сложности
прост: простой простая
средн: средний среднего
сложн: сложный сложная
примен: применить
час: часов час
нейросетев: нейросетевое
генеративн: генеративное
искусств: искусство
программист: программисту программист
художник: художником
прочтен: прочтение
мин: мин
количеств: количество
просмотр: просмотров
блог: блог
машин: машинное машинного машинным
обучен: обучение обучения обучением
конференц: конференции
искусствен: искусственный искусственного
интеллект: интеллект интеллекта
наверняк: наверняка
глубок: глубоко глубокие
изуч: изучившие
генерац: генерацию
картинок: картинок
помощ: помощью
нейросет: нейросетей нейросети
ещ: ещ
разбира: разбирался
назван: названии
слов: слово
диффуз: диффузия
разновидн: разновидности
различа: различаются
гот: готов
забира: забираться
дебр: дебри
хочет: хочет хочется
присест: присест
наверста: наверстать
вс: вс
главн: главное
полез: полезен
доклад: доклад докладу докладов докладами доклады
дмитр: дмитрия дмитрий
сошников: сошникова
наш: нашего нашей наших нашем
мероприят: мероприятия
поэт: поэтому
сдела: сделали сделать сделан
текстов: текстовую
расшифровк: расшифровку
видеозап: видеозапись
прилага: прилагаем
полгод: полгода
успел: успели
разв: развиться
сильн: сильнее
тем: тема
интересн: интересна интересны
заодн: заодно
порекоменду: порекомендуем
след: следующий следить следующем следующим
пройд: пройд
завтр: завтра
апрел: апреля апреле
цел: целый целях целям целом
ряд: ряд
числ: числе число
участ: участие
бесплатн: бесплатно бесплатный
дал: далее
повествован: повествование
ид: ид идеи идей
лиц: лица
чита: читать читайте
голос: голосов
добав: добавить добавили
закладк: закладки
комментар: комментарии
разработчик: разработчикам разработчики
расскажут: расскажут
дошл: дошла
юбилейн: юбилейной
й: й
верс: версии версиям версию
сво: своя своим свой
кругл: круглая
дат: дата
вперв: впервые
прошл: прошла прошлым прошлой
как: каких какому какое
язык: языке языка
юбиляр: юбиляре
ожида: ожидать ожидаемый
вод: водится воды
программ: программе программы
разн: разные разными
тематическ: тематические
блок: блоки
инструмент: инструментах
познава: познавать
производительн: производительности
научат: научат
пользова: пользоваться
профайлер: профайлером
задач: задач задача
архитектур: архитектуре
тестирован: тестировании тестирование
реактивщин: реактивщине
работ: работе работы работу
дан: данными данные данной
полн: полный полны
описан: описаниями
пост: посте постом
хакнул: хакнули
яндекс: яндекс
истор: история историю истории
экологичн: экологичного
перв: первого первом
реша: решался решаем решаться
рассказа: рассказать
конц: конце концов
аморальн: аморальна
наруша: нарушает
частн: частную
пользовател: пользователей пользователя
крупн: крупного крупнейшая крупной крупный
маркетплейс: маркетплейса
подписчик: подписчики
мо: моего мое
телегр: телеграм
кана: канала
так: таки таков таких такими такого
уговор: уговорили
нашл: нашли
способ: способ
получа: получать получается получал
клиент: клиентов клиенты клиентами
зависим: зависимости зависимостей
ниш: ниши нишу
дырк: дырке
маркет: маркета маркете
знал: знали
почт: почты
покупател: покупателей
куп: купили купить
могл: могли
предлож: предложить предложив
сопутств: сопутствующий
товар: товар товаров товару
значк: значков
интернет: интернет интернета интернете
контент: контент контентом
мнен: мнение
русскоязычн: русскоязычная
площадк: площадка
специалист: специалистов
технологическ: технологических
стартап: стартапов стартапа стартапам
сфер: сферы
технолог: технологий
вмест: вместе
переста: перестает
развива: развиваться развиваю
обоснова: обосновано
хотел: хотел хотели
внест: внести
небольш: небольшие небольшой
вклад: вклад
развит: развитие
мотиватор: мотиватором
жела: желает
писа: писать писали
анализ: анализу
трафик: трафика
феврал: февраль
посещен: посещений
период: период
декабр: декабря
мар: мар
пут: путь
изуча: изучаем
диаграмм: диаграмме диаграмму
сенк: сенки
пиар: пиарюсь
обзор: обзор
времен: временами
отвлеч: отвлечься
рутин: рутины
техническ: технической технических техническая
документац: документации
посмотрет: посмотреть
счаст: счастью
вселен: вселенная
услыша: услышала
лет: летом
публикова: публиковал
решен: решение решений решению
продуктов: продуктовой
аналитик: аналитики аналитику аналитика аналитикой
утекл: утекло
проект: проект проектов проектами проекты
знатн: знатно
доработа: доработали доработано
радост: радостью
реш: решил решено решить
пример: примерить примере
рол: роль роли
юн: юного
исследовател: исследователя
поведен: поведения
посмотр: посмотрим
последн: последние последний
месяц: месяцы месяц
установ: установим
скрипт: скрипт
сервис: сервиса сервисы сервисов сервис
движок: движок
плагин: плагином
магазин: магазина магазин магазинов
постро: построим построить
сэнк: сэнки
привлеч: привлечь
приложен: приложение приложений приложения
млн: млн
геймификац: геймификации геймификацию
оп: опыт
спортмастер: спортмастера спортмастер
игр: игр игры игру
мобильн: мобильных мобильное
повышен: повышение
конверс: конверсии
кейс: кейс кейсы кейсов кейсом
запуст: запустили запустить
встро: встроив
дополнительн: дополнительные дополнительных
мед: медиа
трекер: трекер
активн: активности активность активных активно
трансляц: трансляции
онлайн: онлайн
тренировк: тренировки
закрыва: закрывают
потребн: потребности
связа: связанные связаться связались
покупк: покупками
например: например
помога: помогают помогаем
спортивн: спортивными
поддержива: поддерживать
физическ: физическую
част: частью часть
сообществ: сообщества
единомышленник: единомышленников
некотор: некоторые некоторый
заход: заходили
воспринима: воспринимали
спорт: спорта
познаком: познакомить
возможн: возможностями возможность
увелич: увеличить
зовут: зовут
серг: сергей
вылекжанин: вылекжанин
начальник: начальник
отдел: отдела
расскаж: расскажу
использ: используют используется
бизнес: бизнес бизнеса бизнесам
привлечен: привлечения
удержан: удержания
стимулирован: стимулирования
покупок: покупок
продвижен: продвижения продвижение
услуг: услуг услуга услуги
исключен: исключение
запуск: запуске
придержива: придерживались
принцип: принципов
клиентоориентирован: клиентоориентированность
провел: провели
исследован: исследование исследования исследованиями
учл: учли
интерес: интересы интерес
концепц: концепции
вовлека: вовлекающей
коммерческ: коммерческая
эффективн: эффективность эффективности эффективно эффективный
отказа: отказались
аренд: аренды
готов: готовых
разработа: разработали
собствен: собственную собственно
информацион: информационную
сист: систему систем
поможет: поможет
многократн: многократно
перезапуска: перезапускать
вложен: вложений
конечн: конечном
итог: итоге
подход: подход подходов
полност: полностью
оправда: оправдал
ищ: ищем
внедрен: внедрения
инфраструктур: инфраструктура
вещ: вещей
управлен: управление
монетизац: монетизация
сер: серов серь
явля: являюсь
руководител: руководителем
направлен: направления направление
промышлен: промышленного промышленных
ит: ит
индустр: индустрии
работа: работаю работаем работают работающих
занима: занимаюсь заниматься
отрасл: отраслях
телек: телеком
сельск: сельское
хозяйств: хозяйство
жкх: жкх
д: д
предприят: предприятий
сталкива: сталкиваюсь
ситуац: ситуациями
очевидн: очевидных
узк: узких
мест: мест
болев: болевых
точек: точек
производствен: производственной
систем: системы
цифровизац: цифровизации
звуч: звучит
общ: общее общего
актив: активов
случа: случае
встает: встает
вопрос: вопрос
найт: найти
дадут: дадут
результат: результат результатах
повыс: повысят
производств: производства производству
подел: поделюсь поделиться
опыт: опытом опыта
проблем: проблемах
котор: которыми
иска: искать
точк: точки
старт: старта
поменя: поменялось
кварта: квартал
социальн: социальные
сет: сети
привет: привет
сайт: сайте сайтов сайта сайты
появля: появляется
значим: значимая
фич: фича
дела: делаем делать
отдельн: отдельную отдельно отдельным
публикац: публикацию публикаций публикации
противн: противном
расширен: расширенный
чейнджлог: чейнджлог
квартал: квартале
вышл: вышло
тип: типом
пользовательск: пользовательских
пришл: пришлось
продела: проделать
больш: большую большого
снаруж: снаружи
капот: капотом
планиру: планируем
выкат: выкатить
нововведен: нововведение
разниц: разнице
подводн: подводных
камн: камнях
сберкорус: сберкорус
поисков: поисковая
оптимизац: оптимизация
копирайт: копирайт
обсуд: обсудим
текст: тексты
оборот: оборотами
пластиков: пластиковые
окн: окна
недор: недорого
может: можете
москв: москве
имеют: имеют
баланс: баланс
требован: требованиями
поисковик: поисковиков
экспертн: экспертным
продвига: продвигать продвигаться
изначальн: изначально
спрос: спрос
реж: режим
редактор: редактор
веб: веб
прос: просили просить
дневник: дневник дневниках
настольн: настольный настольной
мотив: мотивам
танчик: танчиков
арх: архив
рабоч: рабочих рабочий рабочие рабочего
прототип: прототипов прототип
графическ: графический
образова: образовался
перер: перерыв
основн: основную
ход: ходе
описа: описали
подготовк: подготовкой
верстк: версткой
макет: макетов макеты
компонент: компонентов компоненты компонентами
правил: правилами
оформлен: оформлением
сдан: сданы
печа: печать
сам: самое
разобра: разобрать разобрали
накоп: накопившиеся
архив: архивы
показа: показать
кажд: каждой каждому каждого
итерац: итерации итераций
прав: правила
изготовлен: изготовленные
вручн: вручную
сыгра: сыграть
поня: понять
игров: игровую
механик: механику
зрен: зрения зрению
эргономик: эргономики
дает: дает
выглядет: выглядеть
печат: печати печатью
классик: классике
черн: черно
бел: белом
лазерн: лазерном
принтер: принтере
полноцен: полноценной полноценный
цветн: цветной
меня: менялся
пиксельн: пиксельный
стил: стиль
примитивн: примитивного
битн: битного битным
финальн: финального
условн: условно
назва: назвать
созда: создать
сквозн: сквозную сквозным
коленк: коленке
контекстн: контекстная
реклам: реклама
продаж: продажами продажам
песочниц: песочницы песочница
связ: связи
тан: таня
хоч: хочу
команд: командой команде
реализова: реализовала
схем: схему
подсчет: подсчета
доход: дохода доход
выкуп: выкупом
получ: получилось получить получил
свест: свести
расхожден: расхождение
отчет: отчетом
ориентир: ориентирующимся
метрик: метрику метрике
приемлем: приемлемых
идеальн: идеальной идеальную
картин: картине
классн: классные
выгружа: выгружают
собственник: собственник
вид: видит
копеечк: копеечки
заказ: заказу заказов
легк: легко
счита: считает считается
прибыл: прибыль
реальност: реальности
существ: существует
позвол: позволить
видет: видеть
учет: учетом
отменен: отмененных
возвращен: возвращенных
миллиард: миллиарды
секс: сексе
любв: любви
правильн: правильно
знаком: знакомиться
дейтинг: дейтинг
модел: модели моделей
интерв: интервью
бывш: бывший
директор: директор
продукт: продукту продуктом
дел: делится дела деле делимся
зарабатыва: зарабатывает
правд: правда
пар: пару
подбира: подбирает
и: ии
инвестиц: инвестиции
знакомств: знакомств знакомству
бонус: бонус
рекомендац: рекомендации
парн: парней
девушек: девушек
позна: познается
сравнен: сравнении
популярн: популярных
рф: рф
успех: успех
люб: любой
напрям: напрямую
завис: зависит
наскольк: насколько
сотрудник: сотрудника сотрудников
менеджер: менеджеры менеджеру
звен: звена
табельн: табельных
трат: тратят
непродуктивн: непродуктивную
деятельн: деятельность
неэффективн: неэффективное
использован: использование
потенциа: потенциала
съеда: съедает
избежа: избежать
цифров: цифровые цифровой
выстраиван: выстраивания
организацион: организационной
структур: структуры структуру
российск: российском
рынк: рынке
материал: материале
скоринг: скоринг
оценк: оценка оценкой оценку
агентств: агентстве агентства
туториа: туториал
высок: высоком
ценов: ценовом
сегмент: сегменте сегменту сегмент
важн: важно
мэтч: мэтч
оценива: оцениваем
входя: входящие
обращен: обращения
нескольк: нескольким нескольких
критер: критериям
исход: исходя
отнест: отнести
лид: лид
обрабатыва: обрабатываем
процесс: процессам
беспилотн: беспилотные беспилотных
автомоб: автомобили
китайц: китайцы
платн: платный
доступ: доступ
будущ: будущее будущий
ждет: ждет
мтс: мтс
термин: термин
постепен: постепенно
перебра: перебрался
фантастик: фантастики
вход: входит
лексикон: лексикон
невозмож: невозможен
приблиз: приблизились
благодар: благодаря
трансформер: трансформеров
линейк: линейке
загоруйк: загоруйко
фундаментальн: фундаментальными
руковож: руковожу
групп: группой
обработк: обработке
естествен: естественного
компьютерн: компьютерному
обсто: обстоят
мир: мире
автомобил: автомобилей
приглашен: приглашение
выступлен: выступление
пройдет: пройдет
март: марта
банальн: банальностей
фестивал: фестиваль
хайп: хайпа
уста: устать
говор: говорят
зачаст: зачастую
однообразн: однообразно
увол: уволят
никак: никакой
одн: одни одна
рассужда: рассуждают
дива: дивана
заката: закатав
рукав: рукава
абстрактн: абстрактными
рассужден: рассуждениями
провед: провед
выступ: выступят
рассчита: рассчитаны
личн: лично
трет: третьи
смотр: смотрят
ракурс: ракурса
управля: управлять
клубничк: клубничка
торт: торте
садоводств: садоводству
дух: духе
раз: раза разы
шаг: шагов шаг шагом
арт: артем
первухин: первухин
продакшн: продакшн
кинетик: кинетика
успешн: успешно
смел: смело
наработк: наработками
грамотн: грамотную
углуб: углубимся
конкретн: конкретные
этап: этапы
нул: нуля
сраз: сразу
покажет: покажет
бо: бою
соглас: согласитесь
горазд: гораздо
прощ: проще
потрат: потратить потратил
деньг: деньги
настройк: настройку настройка
начал: начале
спуст: спустя
обнаруж: обнаружить
ошибок: ошибок
плох: плохую
индексац: индексацию
исправ: исправить
вариант: вариант
обойдет: обойдется
дорож: дороже
приготовьт: приготовьтесь
окунут: окунуться
создав: создавая
каркас: каркас
аккумулятор: аккумуляторов
разумн: разумно
обманыва: обманывать
век: век
мал: малого
выяснен: выяснение
причин: причин причины причину причина
отклонен: отклонения
негативн: негативного
отзыв: отзыва
написа: написанный написал
агрегатор: агрегатор
цветочн: цветочных
подробн: подробности
повторя: повторять
напомн: напомню
удивлен: удивления удивление
негодован: негодования
заключа: заключалась
озвучиван: озвучивания
очередн: очередной
низк: низкой
исправля: исправлял
указа: указанную
приход: приходили
совместн: совместному
фейков: фейковая
отказ: отказа
продолжа: продолжалось
недел: недель неделю недели
ответ: ответ ответа ответили
диалог: диалог
прекрат: прекратился
привож: привожу
целик: целиком
переводчик: переводчик
исполн: исполнилось
фирм: фирму
перевод: переводом переводил
мног: многое
произошл: произошло
сервер: серверов
миллион: миллиона
помн: помню
врем: времена
дво: двое
сидел: сидели
маленьк: маленькой
комнат: комнате
вентиляц: вентиляции
открыва: открывать
задохнут: задохнуться
надежд: надежд
желан: желания
сможет: сможет
конкурирова: конкурировать
собра: собрать
уда: удалось
оказа: оказалось
установк: установку
ос: ос
действова: действовать
перекомпилирова: перекомпилировать
библиотек: библиотек
куч: кучей
пош: пош
л: л
фриланс: фриланса
размест: разместил
объявлен: объявлений
откликнул: откликнулось
заявок: заявок
ясн: ясно
предложен: предложений
аутсорс: аутсорс
образован: образованию
инженер: инженер
заявлен: заявление
вызыва: вызывало
попробова: попробовать
сторон: стороны
выглядел: выглядело
зно: зно
общен: общение
вел: велось
имен: имени
юридическ: юридического
заказа: заказать
треб: требуется
сто: стоит
отмет: отметить
размер: размеру
известн: известный
бренд: бренд
лидер: лидер
восточн: восточной
европ: европе
обеща: обещали
течен: течение
точн: точно
свяжут: свяжутся
ладн: ладно
сюд: сюда
аккаунт: аккаунт
войт: войти
регистрац: регистрация
раздел: разделы
информац: информация
устройств: устройство
документ: документы
соглашен: соглашение
конфиденциальн: конфиденциальность
корпоративн: корпоративный
медийн: медийная
нативн: нативные
образовательн: образовательные
мегапроект: мегапроекты
дзен: дзен
поддержк: поддержка
вернут: вернуться
стар: старую
rss: rss
alex: alex
g: g
jug: jug
ru: ru
group: group
process: processing
stabl: stable
diffus: diffusion
shwar: shwars
techtrain: techtrain
ai: ai
savanmi: savanmi
java: java
jpoint: jpoint
spring: spring
boot: boot
tdd: tdd
perf: perf
jvm: jvm
vikdovnar: vikdovnar
growth: growth
hack: hacking
vikenot: vikenot
badcasedaili: badcasedaily
similarweb: similarweb
bosonbeard: bosonbeard
ux: ux
rocket: rocket
wordpress: wordpress
woocommerc: woocommerce
sankei: sankey
sergeyvyl: sergeyvyl
sportmast: sportmaster
lab: lab
e: e
commerc: commerce
io: ios
android: android
live: live
umnodigit: umnodigital
iiot: iiot
umno: umno
digit: digital
boomburum: boomburum
habr: habr
sergeich: sergeich
s: s
seo: seo
b: b
markdown: markdown
pradd: pradd
dendi: dendy
atlantanalyt: atlantanalytics
crm: crm
tw: tw
face: face
mamba: mamba
itnew: itnews
hr: hr
tech: tech
tdsgn: tdsgn
sergeyzyo: sergeyzyo
gpt: gpt
chatgpt: chatgpt
nlp: nlp
true: true
dai: day
phillennium: phillennium
midjournei: midjourney
ml: ml
pervuhin: pervuhin
kinetica: kinetica
recoveri: recovery
mode: mode
perform: performance
red: red
lemur: lemur
aliaksei: aliaksei
rudak: rudak
googl: google
linux: linux
window: windows
facebook: facebook
twitter: twitter
vk: vk
telegram: telegram
youtub: youtube
