организац: организациям
способ: способы
доставк: доставки
оплат: оплаты принимаем
возврат: возврат
обм: обмен
загруз: загрузить
росс: россия
магазин: магазины магазинах
оптов: оптовые
отдел: отделы
регистрац: регистрация
вход: вход
статус: статус
заказ: заказа сделать
корзин: корзина корзину
руб: руб
каталог: каталог производителей
товар: товаров товары товара товаром
виде: видео
стат: статьи планируете
новост: новости
популярн: популярное
электрон: электронные
компонент: компоненты
измерительн: измерительные
прибор: приборы
оптоэлектроник: оптоэлектроника
кнопк: кнопки
переключател: переключатели
разъем: разъемы
рел: реле
паяльн: паяльное паяльных
оборудован: оборудование
инструмент: инструмент
расходн: расходные
материал: материалы
корпусн: корпусные
установочн: установочные
издел: изделия
электротехник: электротехника
блок: блоки блок
элемент: элементы
питан: питания
провод: провода
кабел: кабели
антен: антенны
автозапчаст: автозапчасти каталоги
электроник: электроника электроники
инженерн: инженерная
сантехник: сантехника
запчаст: запчасти
техник: техники техника
средств: средства
разработк: разработки
конструктор: конструкторы
модул: модули
набор: наборы
главн: главная
промышлен: промышленная
автоматик: автоматика
таймер: таймеры таймер
изображен: изображения
служат: служат
ознакомлен: ознакомления
см: см
техническ: техническую технические техническая
документац: документацию документация
шт: шт
склад: склада
москв: москва
запрос: запросу
добав: добавить
сумм: сумму
кред: кредит
мес: мес
номенклатурн: номенклатурный
номер: номер
артикул: артикул
стран: страна
происхожден: происхождения
коре: корея
республик: республика
бренд: бренд
производител: производитель комбинированные
описан: описание
аналогов: аналоговый
установк: установка
колодк: колодку
многофункциональн: многофункциональный
фунц: фунции
програмируем: програмируемых
режим: режимов
сек: сек
ч: ч
штырьков: штырьковых
контакт: контактов контакт
параметр: параметры параметров
напряжен: напряжение
предельн: предельный
ток: ток
вес: вес
показа: показать
похож: похожие
кб: кб
срок: сроки
выбер: выберите
регион: регион
увидет: увидеть
получен: получения
цен: цена
налич: наличие
город: город
санкт: санкт
петербург: петербург
архангельск: архангельск
астрахан: астрахань
барнаул: барнаул
белгород: белгород
брянск: брянск
владимир: владимир
волгоград: волгоград
вологд: вологда
воронеж: воронеж
екатеринбург: екатеринбург
иванов: иваново
ижевск: ижевск
иркутск: иркутск
казан: казань
калуг: калуга
кемеров: кемерово
кир: киров
костром: кострома
краснодар: краснодар
красноярск: красноярск
курга: курган
курск: курск
липецк: липецк
набережн: набережные
челн: челны
нижн: нижний нижнего
новгород: новгород
новосибирск: новосибирск
омск: омск
ор: ор
л: л
оренбург: оренбург
пенз: пенза
перм: пермь
псков: псков
рост: ростов
дон: дону
рязан: рязань
самар: самара
саранск: саранск
сарат: саратов
смоленск: смоленск
ставропол: ставрополь
твер: тверь
томск: томск
тул: тула
тюмен: тюмень
ульяновск: ульяновск
уф: уфа
чебоксар: чебоксары
челябинск: челябинск
ярославл: ярославль
покупа: покупают
вт: вт
отладочн: отладочная
плат: плата
баз: базе
драйвер: драйвер
ключ: ключей
верхн: верхнего
уровн: уровней
мультиметр: мультиметр
цифров: цифровой
печатн: печатная
разводк: разводкой
рекоменду: рекомендуем
измерител: измерители
качеств: качества
электроэнерг: электроэнергии
подставк: подставки
паяльник: паяльников газовые
кронштейн: кронштейны
креплен: крепления
станц: станций
осциллограф: осциллографы
аксессуар: аксессуары
газов: ним
горелк: паяльники
температур: горелки
влажност: температуры
комбинирова: влажности
акц: автозапчастей
спецпредложен: акции
калькулятор: спецпредложения
обратн: калькуляторы
связ: обратная
политик: связь
конфиденциальн: политика
пользовательск: конфиденциальности
соглашен: пользовательское
компан: соглашение
истор: компании
чип: история
дип: чип
сфер: дип
контактн: сфере
информац: контактная
реквизит: информация
за: реквизиты
дистрибьюц: зао
планирует: дистрибьюция
поставщик: стать
работ: поставщиком корректной
куп: работа
сдела: купить
состоян: заказ
редактирован: состояние
юридическ: редактирование
лиц: юридических
скача: лиц
мобильн: скачайте радиодетали
приложен: мобильное
принима: приложение
соцсет: оплате
радиодета: соцсетях
верс: мобильная
корректн: версия
страниц: работы
ваш: страницы
браузер: вашем
необходим: браузере
разреш: необходимо
использован: разрешить
chipdip: chipdip
bom: bom
chipdipdac: chipdipdac
auton: autonics
n: n
vac: vac
vdc: vdc
partnumb: partnumber
b: b
ac: ac
dc: dc
pg: pg
ps: ps
ai: ai
al: al
sp: a
sw: sp
dl: sw
atxxn: dl
pdf: atxxn
hdr: pdf
st: hdr
microelectron: st
nucleo: microelectronics
l: nucleo
mcu: l
stm: mcu
ret: stm
arm: ret
infineon: arm
ir: infineon
strpbf: ir
soic: strpbf
uni: soic
trend: uni
ut: trend
true: ut
rm: true
kicad: rms
ct: kicad
e: ct
mail: e
sale: mail
ru: sales
kz: ru
javascript: kz
