хабр: хабр
откр: открыть
список: список
стат: стать статьи статье статей
автор: автором авторы авторов
поток: потоки
разработк: разработка разработкой разработки разработке
администрирован: администрирование
дизайн: дизайн
менеджмент: менеджмент
маркетинг: маркетинг
научпоп: научпоп
поиск: поиск поиска поиске
профил: профиль профиля
обнов: обновить
рейтинг: рейтинг рейтинга
карьер: карьера карьеры карьере карьеру
индустр: индустрии
работа: работать работают работала работало
компан: компании компаниями компаний компания компаниях компанию
подряд: подряд
скопирова: скопировать
ссылк: ссылку
показыва: показывать
нов: новые новых новой новым
лучш: лучшие лучших
порог: порог
уровен: уровень
сложност: сложности
прост: простой проста простые
средн: средний среднем
сложн: сложный сложно
примен: применить
час: часа часов
аналитик: аналитиком аналитика аналитике
дан: данных данной
прочтен: прочтение
мин: мин
количеств: количество количества
просмотр: просмотров
анализ: анализ
проектирован: проектирование
сист: систем систему
учебн: учебный
процесс: процесс процессе процессов процессы
роадмэп: роадмэп
современ: современном современным современной
мир: мире мир
представля: представляет
одн: одну одни одном одним одно
востребова: востребованных
перспективн: перспективных
професс: профессий
больш: большое большие
котор: которое которую
генерир: генерируется
использ: используется
различн: различных различные
отрасл: отраслях отрасли
став: ставит
организац: организациями
задач: задачу задача задаче задач задачи
высококвалифицирова: высококвалифицированных
специалист: специалистов специалистам специалисты специалисту
способн: способных
обрабатыва: обрабатывать
анализирова: анализировать
информац: информацию информации информация
рассмотр: рассмотрим
как: какие какими каким какую
требован: требования требований требованиям
предъявля: предъявляются
сфер: сфере
навык: навыками навыков навыки навык
знан: знаниями
облада: обладать
успешн: успешной успешного
чита: читать
дал: далее дал
голос: голосов
добав: добавить
закладк: закладки
комментар: комментарии
новост: новости
собеседован: собеседование собеседования собеседовании
экзам: экзамен
блог: блог
цифров: цифровой
сибур: сибур
управлен: управление управлением
персонал: персоналом
кейс: кейс кейсами
знаком: знакомо
чувств: чувство чувствах
пришел: пришел
люд: людей людям
посмотрет: посмотреть
показа: показать показали
ушел: ушел
вспотевш: вспотевшими
ладошк: ладошками
смеша: смешанных
мысл: мыслями
ребят: ребята
неужел: неужели
понима: понимаете
недоумев: недоумевая
преврат: превратилось
увер: уверен
подраст: подрасту
точн: точно точный
стан: стану
повторя: повторять
ошибок: ошибок
мо: моих мо
нанимател: нанимателей
ув: увы
нача: начал
провод: проводить
повтор: повторилось
угод: угодил
ловушк: ловушку
приглаша: приглашаем
онлайнов: онлайновый
митап: митап
карьерн: карьерный карьерного
трек: трек
разработчик: разработчика разработчиков разработчик
лаборатор: лаборатория лаборатории
касперск: касперского
программирован: программирование программирования программированием
сред: среду среди среде
апрел: апреля
мск: мск
провед: проведем
назван: названием
нюанс: нюансов
участ: участием
наш: наших
коллег: коллег коллегами
менеджер: менеджеров менеджеру
тимлид: тимлидов тимлидом тимлид
разн: разных разные разнятся
команд: команд команды команде команду команда
спикер: спикеры
расскажут: расскажут
элемент: элементы
развит: развития развитие
учет: учетом
изменен: изменений
стандарт: стандартов
язык: языка
представлен: представленных представление
росс: россии
обсуд: обсудят
хвата: хватает
активн: активность
найм: найма наймом
рынк: рынке
март: марте
исследован: исследования исследование
прогноз: прогнозы
ежемесячн: ежемесячно
смотр: смотрим смотрят
публик: публикуют
ваканс: вакансий вакансии вакансия
изуча: изучаем
разрез: разрезе
специализац: специализаций
квалификац: квалификаций
ещ: ещ
собира: собираем
эффективн: эффективные эффективных эффективность эффективно
месяц: месяц
привлекл: привлекли
вниман: внимания внимание
разбира: разбираемся разбираем
происход: происходило
истор: истории
гибридн: гибридные гибридной
рол: роль
способ: способы
коммуникац: коммуникаций коммуникация коммуникации
билайн: билайн
проект: проектами проекте проект проекты проекту проекта
правильн: правильная правильный
главн: главных
фактор: факторов
успех: успеха
прова: провала
продуктов: продуктовой продуктового продуктовый
поддержк: поддержки поддержка
функциона: функционала
вовс: вовсе
очевидн: очевидна очевидно
взгляд: взгляд
участв: участвуют
опыт: опыту опыте опыта
должност: должности
темперамент: темпераменту
характер: характеру
основн: основные основных основными основной
внутр: внутри
дава: давайте
сравн: сравним сравнить
работ: работе работы работу
исход: исходя
метод: метода методы
форм: формы форме
передач: передачи
реч: речь
идет: идет
электрон: электронных
письм: письмах
чат: чатах чате
виде: видео
ауд: аудио
конференц: конференциях
реж: реже
очн: очных
встреч: встречах
итак: итак
порядк: порядку
останов: остановись остановить
мгновен: мгновенье
медлен: медленное медленного
тренд: тренд
уста: уставших устали
хочет: хочется
дик: дикую
гонк: гонку
получ: получить получим получится
удовольств: удовольствие
вдумчив: вдумчивого
размерен: размеренного
написан: написания
код: кода
обдумыван: обдумывание
алгоритм: алгоритмов
архитектурн: архитектурных
вариант: вариантов
систем: системы системой
тянет: тянет
протянут: протянуть
рук: руку
стоп: стоп
кран: крану
взбес: взбесившийся
конвейер: конвейер
штамповк: штамповке
недолговечн: недолговечных
решен: решений решения
бесконечн: бесконечных
дедлайн: дедлайнов
совещан: совещаний
спринт: спринтов
возможн: возможно
прид: прид
тся: тся
душ: душе
концепц: концепция концепции
сут: сути
полност: полностью
противоположн: противоположна противоположности
мейнстрим: мейнстриму
постоя: постоянному
ускорен: ускорению
попробу: попробуем
рассмотрет: рассмотреть
плюс: плюсы
минус: минусы
апр: апр
добр: добро
пожалова: пожаловать
приключен: приключений приключение
сервер: серверу сервера сервер
част: часть частых
инфраструктур: инфраструктура
перевод: перевод
состо: состоит
нескольк: нескольких
компонент: компонентов компонентами
значительн: значительная
взаимодейств: взаимодействий взаимодействуют взаимодействия
итогов: итогового итоговую
пользовател: пользователя пользователи пользователей пользователями
осуществля: осуществляется
помощ: помощи
отправн: отправную
точк: точку точки
мног: многих многие многое
функц: функций
созда: создал создать
существован: существования
расшир: расширен
поддержан: поддержания
дополнительн: дополнительной
произвольн: произвольной
функциональн: функциональности функциональными
поэт: поэтому
оказыва: оказывается
ограничен: ограниченным
мест: местом место мест
изначальн: изначально
задума: задумано задуматься
размещен: размещения
крайн: крайней
мер: мере
хорош: хорошего хорошие хорош хорошая
сер: серии
погруз: погрузимся
дета: детали
параллельн: параллельно
поэкспериментиру: поэкспериментируем
замен: заменой
пользовательск: пользовательских пользовательскими
создад: создадим
инструментар: инструментарий
модифицирова: модифицировали
соответств: соответствии соответствуют
знает: знает
постро: построим
собствен: собственный
типичн: типичных типичные
исправ: исправить
туториа: туториал
явля: является являются
социальн: социальных
сет: сетей
ит: ит
имеет: имеет
ктивн: ктивными
отклика: откликаются
получа: получают получаем
ответ: ответов
подход: подходы подходят подход подхода
помога: помогают
увелич: увеличить
запрос: запросы
например: например
прям: прямое
общен: общение общения
работодател: работодателями работодателей работодателю
верн: верного
результативн: результативного
треб: требуется
сдела: сделать
ряд: ряд
подготовительн: подготовительных
действ: действий
перв: первое первом
обновлен: обновление
исправлен: исправление исправления
ошибк: ошибки
встреча: встречаются
негативн: негативно
повлия: повлиять
уменьш: уменьшить
шанс: шансы
получен: получение
отклик: откликов
сто: стоит
соверша: совершают
создан: создании создания создание
поясня: поясняем
повыс: повысить
счет: счет
идт: идти
агротех: агротех
рсхб: рсхб
интех: интех
россельхозбанк: россельхозбанк
мнен: мнение
узна: узнать
пришл: пришлось
выезжа: выезжать
ферм: ферму
личн: личный личном личное
оп: опыт
наскольк: насколько
радужн: радужно
стран: стране страна
лепрекон: лепреконов
дел: деле
ждет: ждет
реш: решит
перееха: переехать
ирланд: ирландию ирландия ирландии
эмиграц: эмиграция
лайфхак: лайфхаки
гик: гиков
урбанизм: урбанизм
интерв: интервью
красив: красивая
маленьк: маленькая маленьких
ассоциир: ассоциируется
проч: прочим
невысок: невысоких
налог: налогов
связа: связаны
технолог: технологиями
охотн: охотно
нанима: нанимают
сотрудник: сотрудников сотрудники
рубеж: рубежа
зовут: зовут
андр: андрей
ноябр: ноября
прошл: прошлого прошлое
жив: живу
расскаж: расскажу
организовыва: организовывал
переезд: переезд
необычн: необычного
увидел: увидел
съ: съ
квартир: квартиры
цел: целое целей целью
кип: кипу
документ: документов документы
придет: придется
оформ: оформить
жизн: жизни
разв: развить
умен: умение
мойофис: мойофис
сам: самых
взаимодействова: взаимодействовать
достига: достигать
рабоч: рабочих
пар: пару
рекрутингов: рекрутинговая
провел: провела
опрос: опрос
результат: результаты результат
занима: занимает занимаются заниматься
списк: списке
призна: признали
гибк: гибкие
важн: важнее
техническ: технических технические техническая
принцип: принципы принципов
командн: командной
бизнес: бизнес бизнеса
продолжа: продолжают
меня: меняться меняйте менялась
станов: становятся становится
вс: вс
кросс: кросс
развива: развивается развивает развивался
культур: культура
участник: участниками
руководител: руководитель руководителя руководителей руководителю руководителями
авторитарн: авторитарно
диктова: диктовать
услов: условия
член: членов
осознан: осознанности
проактивн: проактивности
готовн: готовности
слыша: слышать слышал
друг: друг друга другом
люб: любой
цен: ценятся
умеют: умеют
договарива: договариваться
групп: группе группы группа
кат: катом кат
самостоятельн: самостоятельно
да: даем
полезн: полезные
рекомендац: рекомендации
дво: двоих
газпромбанк: газпромбанк
обзор: обзор
конкретн: конкретная
найт: найти
направлен: направление
человек: человека
имеют: имеют
проектн: проектный проектным
хот: хотят хотите
раст: расти
предполож: предположить
незнаком: незнакомым
ч: ч
поступа: поступать
инструмент: инструментами инструмент
фреймворк: фреймворками
выписа: выписать
оценива: оценивать
важност: важность
кажд: каждого каждом каждой
взвешен: взвешенную
оценк: оценку оценке
ключев: ключевой
момент: момент
ищ: ищем
супергеро: супергероев
нужн: нужны
понятн: понятно
нуж: нужен
факт: факт
хотел: хотел хотелось
рассказа: рассказать
поня: понял
так: таких такую таким
ситуац: ситуациях ситуацию ситуации
кидалов: кидалово
дела: делать делал
тестов: тестовые тестовое
задан: задания задание
представьт: представьте
гипотетическ: гипотетическую
оказа: оказались
го: го
сентябр: сентября
дом: домой
приход: приходили приход
полица: полицаи
интересова: интересовались
наход: находитесь
возраща: возращаться
сыкотн: сыкотно
незакон: незаконного
соверш: совершить
глупост: глупость
взят: взяться
врод: вроде
обеща: обещали
заплат: заплатить
пойт: пойти
нелояльн: нелояльный
немотивирова: немотивированный
должн: должны
лояльн: лояльными
мотивирова: мотивированными
знают: знают
ки: кие
кадр: кадров
существ: существуют
расч: расч
лояльност: лояльности
над: надеюсь
обратн: обратном
одинок: одинок
пример: пример
отрывок: отрывок
обсужда: обсуждали
программист: программистов программист программисту программиста
дне: дней
трансформац: трансформация
основ: основе
продукт: продуктом продукта продукт продуктов продукты
базов: базовых
ориентац: ориентация
реальн: реальные
потребн: потребности
секунд: секунду
создава: создавать создавайте
потребител: потребителя потребителей
вполн: вполне
оптимизац: оптимизации
пропагандир: пропагандируют
заказчик: заказчиками
представител: представители
дума: думают
экспертиз: экспертиза
позволя: позволяет
говор: говорю
абсолютн: абсолютно
возьм: возьмем
планир: планирует
запуст: запустить
тестирован: тестированием тестирования
целев: целевые
отдел: отдел отделов отделы
разрабатыва: разрабатывает разрабатываем
гениальн: гениальную
премирован: премирования
юнит: юнита
выдвинут: выдвинутые
гипотез: гипотезы
никак: никак
доход: доходят
конечн: конечных
образ: образом
втор: втором
случа: случаях случае
нерабоч: нерабочие
рамк: рамках
предлож: предложить
формирован: формирования
оптимальн: оптимального
комфортн: комфортного
жизнен: жизненного
цикл: цикла цикл
выгоран: выгорании
ом: ом
чит: читая
регулярн: регулярно
посмеива: посмеивался
подобн: подобных
проблем: проблемах
золот: золотого
миллиард: миллиарда
весьм: весьма
дорогостоя: дорогостоящих
последн: последние
столкнул: столкнулся
трем: тремя
интересн: интересными
счастлив: счастливым
финал: финалом
претенд: претендую
глубок: глубокое
сформулирова: сформулировал
одновремен: одновременно
вывод: выводы
инженер: инженером инженеры инженеров
миф: мифом
тратьт: тратьте
впуст: впустую
недел: неделю недели
комбинир: комбинируйте
след: следующими
стратег: стратегиями
обнул: обнулите
десят: десяти
дольш: дольше
избежа: избежать
обвинен: обвинений
обфусцир: обфусцируйте
навед: наведите
сует: суеты
прос: просите
выполня: выполнять
напомина: напоминают
презентац: презентации
диаграмм: диаграммы
тикет: тикетами
бессмыслен: бессмысленные
ритуал: ритуалы
джун: джуну джунов
вклад: вклад
пет: пет
яндекс: яндекс
практикум: практикум практикуме
привет: привет
артур: артур
домбровск: домбровский
наставник: наставник
соавтор: соавтор
курс: курса
зарабатыва: зарабатываю
тр: тр
х: х
пров: пров
л: л
старш: старший
финтех: финтех
плотн: плотно
вовлеч: вовлеч
н: н
собесед: собеседую
принципа: принципал
хоч: хочу
отмет: отметить
сказа: сказанное
инсайт: инсайта
резюм: резюме
эйчар: эйчары
помоч: помочь
начина: начинают начиналось
бэкенд: бэкенд
выраст: вырастить
линейн: линейных
стартап: стартапа стартапам
читальн: читальный
зал: зал
руковож: руковожу
офис: офисом
сказбук: сказбуке
мобильн: мобильное
приложен: приложение
игров: игровой
мышлен: мышление
талант: таланты
ребенк: ребенка
претерпел: претерпел
множеств: множество
внешн: внешняя
сторон: сторона сторону
внутрен: внутренние
прич: причем
кардинальн: кардинально
совпа: совпал
очередн: очередным
перестроен: перестроением перестроения
организацион: организационной
структур: структуры
раздел: разделились разделы
некотор: некоторым
управленческ: управленческого управленческие
заня: занять
атмосфер: атмосферу
исполнител: исполнителями
приобрел: приобрели
качеств: качества
стал: стали
увеличен: увеличения
объем: объема
контент: контента
игр: игры игрой
стара: старались
выпуска: выпускать
отдельн: отдельная
отвеча: отвечали отвечаем
реализац: реализацию
юн: юнит
коротк: короткие
срок: сроки
проход: проходили
ид: идеи
концепт: концепта
финальн: финального
публикац: публикации
состав: составить
классн: классное
портфол: портфолио
нетолог: нетология
зрен: зрения
трудоустройств: трудоустройства
счита: считает
содержательн: содержательный
традицион: традиционная традиционные
анкет: анкета
перечислен: перечислением
уч: уч
постепен: постепенно
уход: уходит
тороп: торопятся
хорон: хоронить
соискател: соискателю
прощ: проще
вопрос: вопросы
выглядет: выглядеть
обрат: обратить
сомнева: сомневаетесь
сил: силах
удобн: удобные
сервис: сервисы
сюд: сюда
аккаунт: аккаунт
войт: войти
регистрац: регистрация
хаб: хабы
песочниц: песочница
устройств: устройство
сайт: сайта
соглашен: соглашение
конфиденциальн: конфиденциальность
услуг: услуги
корпоративн: корпоративный
медийн: медийная
реклам: реклама
нативн: нативные
образовательн: образовательные
программ: программы
спецпроект: спецпроекты
дзен: дзен
настройк: настройка
вернут: вернуться
стар: старую
верс: версию
rss: rss
badcasedaili: badcasedaily
python: python
sql: sql
gradien: gradiens
kasperski: kaspersky
lab: lab
c: c
senior: senior
middl: middle
habr: habr
career: career
yuvmichurin: yuvmichurin
aklimenkov: aklimenkov
gtd: gtd
anna: anna
sokol: sokol
api: api
kubernet: kubernetes
southbridg: southbridge
devop: devops
s: s
asa: asa
techrecruit: techrecruiter
linkedin: linkedin
big: big
data: data
engin: engineering
remot: remote
inmail: inmails
rshbdigit: rshbdigital
vityoha: vityoha
getmatch: getmatch
hr: hr
amin: amin
hai: hays
soft: soft
skill: skills
shoview: shoview
tohntobshi: tohntobshi
mytonwallet: mytonwallet
io: io
markshevchenko: markshevchenko
maxrokatanski: maxrokatansky
employe: employee
life: life
cycl: cycle
otu: otus
custdev: custdev
lm: lms
l: l
d: d
b: b
mckinseyba: mckinseyba
happi: happy
patientzero: patientzero
x: x
alikamil: alikamil
open: open
sourc: source
java: java
amazon: amazon
wise: wise
arturmkrtychan: arturmkrtychan
bapxat: bapxat
github: github
hh: hh
nmivan: nmivan
fillpackart: fillpackart
semen: semen
grinshtein: grinshtein
arttom: arttom
ru: ru
vd: vds
m: m
rko: rko
editor: editor
ruvd: ruvds
kesn: kesn
megamozg: megamozg
facebook: facebook
twitter: twitter
vk: vk
telegram: telegram
youtub: youtube
