хабр: хабр хабра
откр: открыть
список: список
стат: стать статьи статье статей
автор: автором авторы автор авторов
поток: потоки
разработк: разработка
администрирован: администрирование
дизайн: дизайн
менеджмент: менеджмент
маркетинг: маркетинг
научпоп: научпоп
поиск: поиск
профил: профиль
обнов: обновить
рейтинг: рейтинг рейтинга
автомобильн: автомобильные автомобильных автомобильный
гаджет: гаджеты гаджетом
устройств: устройства устройств устройство
автомобил: автомобилей автомобиль автомобиля
компан: компании компания компаний
подряд: подряд
скопирова: скопировать
ссылк: ссылку
показыва: показывать показывает
нов: новые новый нового новых
лучш: лучшие лучших
порог: порог
уровен: уровень
сложност: сложности
прост: простой
средн: средний
сложн: сложный
примен: применить
минут: минуту
систем: система системам системах
кругов: кругового
обзор: обзора обзор обзором обзоры
видеокамер: видеокамерой
враща: вращающимися
зеркал: зеркалами
прочтен: прочтение
мин: мин
количеств: количество
просмотр: просмотров
высок: высокая высокой
производительн: производительность производительностью
занимательн: занимательные
задачк: задачки
работ: работа работе работы
виде: видео
фототехник: фототехника
песочниц: песочницы песочница
пиш: пишу
тип: типа
критик: критикуйте
физик: физику
математик: математику
изуча: изучал
ид: идеи
кажут: кажутся
перспективн: перспективными
став: ставят ставит
камер: камер камерам
периметр: периметру
охраня: охраняемой
территор: территории
рыб: рыбий
глаз: глаз
бампер: бампер
авт: авто
неприятн: неприятными
искажен: искажениями
сторон: стороны
глядет: глядеть
напас: напас
шься: шься
широконаправлен: широконаправленные
качествен: качественные
середин: середины
объект: объекта объекты
сверх: сверху
обозрет: обозреть
принцип: принципе
вс: вс
полн: полную полным
сфер: сферу
исключ: исключая
корпус: корпус корпуса
гц: гц
небольш: небольшим
зеркальн: зеркальный
датчик: датчик
зд: зд
подсказа: подсказать
сам: самые самых
интересн: интересные интересных
опасн: опасные опасность опасности
помощ: помощью помощи
нейросет: нейросетей
определ: определить
расстоян: расстояние
люб: любого
габарит: габариты
вычисл: вычислить
скорост: скорость
направлен: направление
текущ: текущую
шник: шников
найд: найд
тся: тся
выгляд: выглядит
чита: читать
дал: далее
добав: добавить
закладк: закладки
комментар: комментарии
новост: новости
апр: апр
беспроводн: беспроводные
аудиолампочк: аудиолампочки
ко: кое
неожида: неожиданные
находк: находки
испанск: испанской испанскую
барахолк: барахолки барахолку
блог: блог блоге
компьютерн: компьютерное
желез: железо
истор: история истории
привет: привет
запоздан: запозданием
рассказыва: рассказываю рассказывает
сво: своем свой
воскресн: воскресном
поход: походе
периодическ: периодически
встреча: встречаю
штук: штуки
айтишн: айтишные
попа: попались попали
весьм: весьма
девайс: девайсы
музыкальн: музыкальные
инструмент: инструменты
конц: конце конца
пост: поста пост постов
оставля: оставляю
фотограф: фотографии
предназначен: предназначение
постав: поставило
тупик: тупик
напомн: напомню
ищ: ищу
гугл: гугле
забан: забанили
хочет: хочется
попробова: попробовать попробовал
угада: угадать
поисковик: поисковика
поеха: поехали
голос: голосов
мар: мар
абсолютн: абсолютно
пят: пятое пятая пяти
поколен: поколение поколения
экологичн: экологичны экологичного
гибрид: гибриды
электромоб: электромобили
научн: научно
популярн: популярное
мир: мире миру
массов: массовый
гибридн: гибридный
легков: легковой
латинск: латинское
слов: слово
яп: яп
тракт: трактуется
изначальн: изначальный
прода: продается
япон: японии
вышл: вышло
котор: которое
похваста: похвастаться
экологическ: экологическими экологические
характеристик: характеристиками
динамическ: динамическими
возможн: возможностями возможное возможности
км: км
час: час
генерац: генерация
привод: приводом
разгоня: разгоняется
секунд: секунды
расходу: расходуя
смеша: смешанном
цикл: цикле
литр: литра
пут: пути путь
тестиру: тестируем
аккумулятор: аккумуляторы аккумуляторов аккумулятор
грузов: грузовых грузового
энерг: энергия энергию
элемент: элементы
питан: питания
транспорт: транспорт транспорта транспорту
легковушк: легковушкой
един: единой
жив: жив
самура: самураю
придержива: придерживающемуся
быт: быту
предельн: предельной
минималистичн: минималистичности
отвлека: отвлекало
интеллектуальн: интеллектуальных интеллектуальную
свершен: свершений
приход: приходится
заказыва: заказывать
крупногабаритн: крупногабаритное
радост: радость
приобретен: приобретения приобретение
огромн: огромного
телевизор: телевизора телевизорам
уютн: уютного
предмет: предмета
мебел: мебели
ещ: ещ
радостн: радостнее
обусловл: обусловлено
добр: добрым
событ: событием событие
сем: семье
например: например
получен: получением
наследств: наследства
рожден: рождением
человек: человека
обществ: общество общества
бизнес: бизнес
жит: жить
вообщ: вообще
испыта: испытаем
пар: пару
мкост: мкостью мкость мкости
цел: целых цель
ч: ч
узна: узнаем
изуч: изучим
специфик: специфику
обслуживан: обслуживания
акб: акб
устро: устроен
электромобил: электромобиль электромобиля
программирован: программирование
микроконтроллер: микроконтроллеров
производств: производство производства
электроник: электроники электроника электроникой электронику электронике
начина: начинающих
туториа: туториал
текст: тексте
сфантазирова: сфантазировать
абстрактн: абстрактный
внутр: внутри
агрегат: агрегаты агрегатов
соедин: соединены
сист: систему
попробу: попробуем
поня: понять
проход: проходит
электричеств: электричество
начин: начиная
зарядн: зарядной
розетк: розетки
заканчив: заканчивая
колес: колесами
инф: инфу
пришл: пришлось
добыва: добывать
видеоурок: видеоуроков
флаер: флаеров
сайт: сайтов сайта
производител: производителей производители производителями производителям
электр: электро
детал: деталей
дета: детали
двигател: двигателя двигатель двигателям
пропан: пропане
репортаж: репортаж
выполн: выполнить
аппаратн: аппаратной аппаратными
начинк: начинки
работа: работают работать
сжижен: сжиженном
разобра: разобраться
фев: фев
больш: большой большим большее большем
тест: тест
азиатск: азиатских азиатского
част: часть частях
заряжа: заряжаем заряжать
ток: током тока
ампер: ампер
испытан: испытания
аккумуляторн: аккумуляторных
батар: батарей
подошл: подошли
завершен: завершению
провер: проверим проверить
как: какие каким
смогут: смогут
запуст: запустить
разряжен: разряженном
состоян: состоянии
низк: низкой
температур: температуре температуры
измерен: измерением измерений
выдержат: выдержат
измер: измерить
конденсатор: конденсатора конденсаторов
лайфхак: лайфхаки
гик: гиков
необходим: необходимо
замет: заметить
дан: данный данных данными данные
мо: мо моей
мнен: мнение
основа: основанное
теоретическ: теоретических
выкладк: выкладках
практик: практике
удосуж: удосужился
параметр: параметров параметр
характериз: характеризующий
активн: активные активно
потер: потери
цеп: цепи
перемен: переменного
исправн: исправных
крайн: крайне
мал: мал
единиц: единиц
ом: ом
милл: миллиом
электролитическ: электролитических
конд: конд
ров: ров
времен: временем
деградир: деградирует
связа: связано
подсыхан: подсыханием
электролит: электролита
мног: многие
обзорщик: обзорщики
отмет: отметили
красивеньк: красивенький
прибор: прибор приборе
умеет: умеет
измеря: измерять
вызва: вызвало
сильн: сильное сильно
разочарован: разочарование
общ: общем
неплох: неплохом
начальн: начального
уровн: уровня
занима: заниматься
инет: инете
снят: снято
над: надеюсь
ютуб: ютубе
ник: никого
отмеч: отмечу
содерж: содержит
простеньк: простенький
осциллограф: осциллограф
встроен: встроенный
генератор: генератор
меандр: меандра
этик: этика
беспилотн: беспилотного беспилотный беспилотных беспилотному
решен: решение
проблем: проблемы проблема
вагонетк: вагонетки вагонетку
искусствен: искусственный
интеллект: интеллект
перевод: перевод
классическ: классический
мыслен: мысленный
эксперимент: эксперимент экспериментов
известн: известный
вопрос: вопрос
должн: должны
переключ: переключить
стрелк: стрелку
отклон: отклонить
несущ: несущуюся
уб: убила
пятер: пятерых
качеств: качестве
альтернатив: альтернативы
придет: придется
столкнут: столкнуть столкнутся столкнуться
рельс: рельсы
останов: остановить
выбор: выбор
сдела: сделать сделай
ситуац: ситуации ситуациями
сформулирова: сформулирована сформулированный
вперв: впервые
английск: английским
философ: философом философы
филипп: филиппой
фут: фут
примечан: примечание
переводчик: переводчика
десятилет: десятилетиями
спор: спорили
след: следует следующего
предпочест: предпочесть
утилитарн: утилитарное
смерт: смертей
цен: ценит
прав: права право
личност: личности
подверга: подвергаться
преднамерен: преднамеренной
последн: последние
год: годы
разработчик: разработчики
автономн: автономных
размышля: размышляли
беспилотник: беспилотники
могл: могли
реша: решать
аналогичн: аналогичные
дилемм: дилеммы
непредвиден: непредвиденными
дорожн: дорожными дорожного дорожные
долж: должен
полос: полосу
внезапн: внезапно
выезжа: выезжает
велосипедист: велосипедист велосипедистом
свернут: свернуть
встречн: встречного
движен: движения
крис: крис
гердес: гердес
заслужен: заслуженный
профессор: профессор
инженерн: инженерных
наук: наук
содиректор: содиректор
центр: центра
исследован: исследований исследование
стэнфорд: стэнфорде
счита: считает
наход: находится находимся
прям: прямо
встро: встроено
обществен: общественный
договор: договор
друг: другими
водител: водителями водителям водителя
наш: наших нашей нашим
правил: правилах
толкован: толковании
суд: судами
совместн: совместно
сотрудник: сотрудниками
опубликова: опубликовал
контекст: контексте
предполага: предполагает
вызовет: вызовет
довер: доверие
янв: янв
взлом: взлом
шгу: шгу
информацион: информационная
безопасн: безопасность безопаснее безопасного безопасную безопасности
втор: вторая
взлома: взломать
официальн: официальную
прошивк: прошивку
выпуск: выпуска
напичка: напичкать
полезн: полезным полезные полезных
нача: начало
прочита: прочитать
одноплатник: одноплатники
вариант: вариантов
январ: января январе
праздник: праздники
прошл: прошли прошлой
успел: успел
отдохнут: отдохнуть
молодец: молодец
продолжа: продолжаем продолжаются продолжали
публикова: публиковать
одноплатн: одноплатных
компьютер: компьютеров
пригод: пригодиться
читател: читателям
опыт: опытов
вмест: вместе вместо
подборк: подборку
традицион: традиционно
достаточн: достаточно
мощн: мощные
фич: фичи
ин: иные
дава: давайте
приступ: приступим
рул: руль
держа: держаться
автомоб: автомобили
развива: развиваются
станов: становятся
умн: умнее умный
резв: резвее
меня: меняют
метод: методы
взаимодейств: взаимодействия
подчеркива: подчеркивают
инновацион: инновационность
интерьер: интерьере
заменя: заменяют
зерка: зеркала
диспле: дисплеям
приборн: приборной
панел: панели
планшет: планшет
эволюционир: эволюционирует
главн: главный
стар: старейший старые старую
интерфейс: интерфейс
хотел: хотели
увидет: увидеть
будущ: будущем будущей будущее будущие
порассужда: порассуждаем
кат: катом
инфраструктур: инфраструктура
перв: первой первых первое
расскаж: расскажем
неудачн: неудачных
попытк: попытках
болгарск: болгарского
ит: ит
специалист: специалиста
радослав: радослава
герганов: герганова
выполня: выполнялся
куп: купил
новеньк: новенький
наткнул: наткнулся
отличн: отличную
сер: серию
сожален: сожалению
описа: описанные описанного
способ: способы
машин: машине машины машин
установл: установлено
отлича: отличается
аналитик: аналитика
подключен: подключенных подключенные
шведск: шведской шведская
баз: баз
специализир: специализируется
транспортн: транспортных
средств: средствах
использ: используют
услуг: услуг услуги
достижен: достижения
разумн: разумного разумно
поддержива: поддерживаем
дух: дух
стартап: стартапа стартапам
горазд: гораздо
крупн: крупной крупнейшей
экосистем: экосистеме
мобильн: мобильности мобильность мобильным
стал: стали стала
обязательн: обязательными
продвижен: продвижения
вперед: вперед
недел: неделе недели
достигл: достигли
цифр: цифры
позволя: позволяет позволяют
создава: создавать
устойчив: устойчивую
масштаб: масштабе
начал: начале
никлас: никлас
флор: флорен
генеральн: генеральный
директор: директор
помоч: помочь
предоставля: предоставлять
нужн: нужны
конечн: конечным
пользовател: пользователям
доб: добиться
масштабируем: масштабируемости
доступн: доступны
рынк: рынках
важн: важно важных
владе: владеем
принадлежат: принадлежат
принципиальн: принципиальной
позиц: позицией позиции
объясня: объясняет
помога: помогаем
использова: использовать
имеющ: имеющиеся
предсказыва: предсказывать
потреб: потребуется
добра: добраться
пункт: пункта
назначен: назначения
использу: используя
внешн: внешние
погод: погода
услов: условия
резервн: резервная резервную
часов: часового
разряд: разряда
солнечн: солнечные солнечной
итог: итоги
техновыставк: техновыставки
дом: дом
эколог: экология
дайджест: дайджест
прогремел: прогремело
значим: значимое
технологическ: технологическое
выставк: выставка выставке выставки
потребительск: потребительской
ежегодн: ежегодно
лас: лас
вегас: вегасе
увлека: увлекаюсь
возобновля: возобновляемой
частност: частности
энергетик: энергетикой энергетики
так: таких
мероприят: мероприятии
посмотрет: посмотреть
реш: решил
подвест: подвести
некотор: некоторые
точк: точки
зрен: зрения
удосто: удостоены
наград: наград
минимум: минимум
номинац: номинаций
категор: категорий
пробежа: пробежаться
хакер: хакеры
выяв: выявили
масс: массу масса
уязвим: уязвимостей
современ: современных
тестирован: тестирование
веб: веб
сервис: сервисов
приобрета: приобретали
велик: велика
вероятн: вероятность
мод: модем
нуж: нужен
разн: разных
функц: функций
врод: вроде
уда: удал
нног: нного
прогрев: прогрева
самодиагностик: самодиагностики
предупрежда: предупреждает
сбо: сбоях
произойдут: произойдут
всевозможн: всевозможных всевозможной
опц: опций
автопроизводител: автопроизводители автопроизводителей
модел: моделях
охотник: охотника
ошибк: ошибками
штатн: штатного
инженер: инженера
сэм: сэма
карр: карри
электрон: электронных электронной
отслежива: отслеживать
контролирова: контролировать
включ: включая
экстрен: экстренных
служб: служб
испытыва: испытывать
предлага: предлагаю
ваш: вашему
вниман: вниманию
результат: результаты
реальн: реальной
дур: дурят
автомобилист: автомобилистов
уаз: уаз
буханк: буханке
реверс: реверс
инжиниринг: инжиниринг
прошедш: прошедший
повлия: повлиял
отечествен: отечественных
появ: появились
антикризисн: антикризисные
комплектац: комплектации
остальн: остальные
исчезл: исчезли исчезла
произошл: произошли
откат: откаты
норм: нормы
вплот: вплоть
евр: евро
прогнозирова: прогнозировал
возврат: возврат
карбюраторн: карбюраторным
счаст: счастью
случ: случилось
шапочк: шапочках
фольг: фольги
рад: рады
эр: эра
глонасс: глонасс
глупц: глупцы
ненужн: ненужной
чипирова: чипировали
вакцин: вакцину
пил: пилить
эб: эбу
преферанс: преферансом
барышн: барышнями
открыт: открытым открытыми
программн: программным
код: кодом
реализац: реализациями
новинк: новинки
экспонент: экспонентов
представ: представят
техническ: технические техническая
инновац: инновации
тенденц: тенденции
одн: одна
выставок: выставок
бытов: бытовой
сокращен: сокращенно
период: период
новатор: новаторы
миров: мировой
индустр: индустрии
соберут: соберутся
игров: игровой
город: город
невад: неваде
дополнен: дополнение
телефон: телефонам
развлекательн: развлекательной
демонстрир: демонстрируются
поставщик: поставщиков
фабиа: фабиан
хоберг: хоберг
собра: собрал
новинок: новинок
сюд: сюда
вклад: вклад
аккаунт: аккаунт
войт: войти
регистрац: регистрация
раздел: разделы
хаб: хабы
информац: информация
документ: документы
соглашен: соглашение
конфиденциальн: конфиденциальность
корпоративн: корпоративный
медийн: медийная
реклам: реклама
нативн: нативные
проект: проекты
образовательн: образовательные
программ: программы
спецпроект: спецпроекты
яндекс: яндекс
дзен: дзен
настройк: настройка
язык: языка
поддержк: поддержка
вернут: вернуться
верс: версию
rss: rss
witf: witfed
rfc: rfc
droman: droman
maquina: maquina
total: total
nintendo: nintendo
ds: ds
selectel: selectel
slavanikolski: slavanikolsky
toyota: toyota
priu: prius
timeweb: timeweb
cloud: cloud
tinyelectronicfriend: tinyelectronicfriends
banner: banner
buffalo: buffalo
bull: bull
shd: shd
ruvd: ruvds
ol: oled
aabzel: aabzel
youtub: youtube
d: d
furukawa: furukawa
batteri: battery
super: super
nova: nova
l: l
panason: panasonic
yuasa: yuasa
n: n
je: je
solit: solite
mazda: mazda
exid: exide
pe: pe
t: t
b: b
premium: premium
ea: ea
mikeveng: mikeveng
esr: esr
fnirsi: fnirsi
dso: dso
tc: tc
arduino: arduino
equival: equivalent
seri: series
resist: resistance
aktia: aktias
tech: tech
center: center
automot: automotive
research: research
stanford: stanford
car: cars
ford: ford
motor: motor
y: y
hyundai: hyundai
tucson: tucson
greiv: greiv
innokenti: innokenty
vyz: vyz
man: man
ioniq: ioniq
audio: audio
greenluigi: greenluigi
wirelesscar: wirelesscar
c: c
oem: oem
bmw: bmw
volkswagen: volkswagen
group: group
volvo: volvo
zel: zel
ce: ces
consum: consumer
electron: electronics
show: show
yuga: yuga
lab: labs
dron: dron
gu: gus
doom: doom
dii: diy
rusefi: rusefi
irina: irina
klein: klein
la: las
vega: vegas
ua: ua
host: hosting
compani: company
mark: marks
aiv: aivs
ivansychev: ivansychev
fillpackart: fillpackart
alizar: alizar
dmitri: dmitry
dor: dor
kolyandex: kolyandex
itelma: itelma
webzuweb: webzuweb
facebook: facebook
twitter: twitter
vk: vk
telegram: telegram
habr: habr
