хабр: хабр
откр: открыть
список: список
стат: стать статьи статье статью статей статьях
автор: автором авторы авторов
поток: потоки потоком
разработк: разработка разработкой разработки разработке
администрирован: администрирование
дизайн: дизайн
менеджмент: менеджмент менеджмента менеджменте
маркетинг: маркетинг
научпоп: научпоп
поиск: поиск
профил: профиль
обнов: обновить
рейтинг: рейтинг рейтинга
управлен: управление управления управлении управлением
проект: проектами проектов проекте проекта проекты проект проектах проекту
застав: заставить
вс: вс
работа: работать работает работают работал работала работаете работали
компан: компании компаниях компания компаний компанию
подряд: подряд
скопирова: скопировать скопировали
ссылк: ссылку
показыва: показывать показывали показывают
нов: новые новому новый новых новым
лучш: лучшие лучших
порог: порог
уровен: уровень
сложност: сложности
прост: простой проста простым простая
средн: средний среднем
сложн: сложный сложно
примен: применить
час: часов
смертн: смертных
грех: грехов
оценок: оценок
задач: задач задача задачу задачами задачи задаче
прочтен: прочтение
мин: мин
количеств: количество
просмотр: просмотров
мнен: мнение
искусств: искусство
наук: наука
оценк: оценки оценку оценке
развит: развита развитие развития развитии
поддержива: поддерживается поддерживающими
программн: программными программной программное
инструмент: инструментами инструмента инструментов
преимуществен: преимущественно
основа: основано основан
эмпирическ: эмпирических
правил: правилах
доработа: доработать
чита: читать читали
дал: далее
голос: голосов
добав: добавить
закладк: закладки
комментар: комментарии
новост: новости
поможет: поможет
нагрузочн: нагрузочное
тестирован: тестирование тестирования
блог: блог блога
групп: группа
сист: систем систему
обзор: обзор
мир: мире
ит: ит
происход: происходят
эволюцион: эволюционные
изменен: изменения изменениям изменений
став: ставят ставить
глав: главу
угл: угла
аспект: аспекты
безопасн: безопасность безопасности
жност: жность
решен: решений решения решение
подобн: подобным подобные
частност: частности
привод: приводит
сервис: сервисов сервисы сервиса сервис
должн: должны должным должна
больш: большим большие большой
числ: числом числа числе
пользовател: пользователей пользователям пользователями
онлайн: онлайн онлайна
банкинг: банкинг
маркетплейс: маркетплейсы маркетплейсах
покупк: покупки
билет: билетов
бронирован: бронирования
бесконтактн: бесконтактная
оплат: оплата оплаты оплату
терминал: терминалы
вспомн: вспомните
последн: последний
плат: платили
касс: кассе
наличн: наличными
метр: метро
запрос: запрос
получен: получение получения
информац: информации информация
госуслуг: госуслугах
д: д
качествен: качественно
создава: создавать
развива: развивать развивает развивался развиваем развиваемся
помим: помимо
понятн: понятных понятную понятно
забот: забот
удобств: удобстве
сохран: сохранности
личн: личных личной
дан: данных данным дано
поджида: поджидают
неочевидн: неочевидные
риск: риски
связа: связанные
рост: ростом
помощ: помощь помощью
приход: приходит приходить приход приходим
н: н
поговор: поговорим
разбер: разбер разберемся
конкретн: конкретные конкретная
жизнен: жизненные
пример: примеры примеров
матриц: матрица матрицу
зрелост: зрелости
проектирован: проектирование
рефакторинг: рефакторинг
песочниц: песочницы песочница
добр: доброе
утр: утро
подним: поднимем
так: такую таки таких такого
интересн: интересную интереснее интересных
тем: тему
современ: современных
реал: реалиях
прийт: прийти
бизнес: бизнесу бизнес
дава: давайте
автоматизиру: автоматизируем
крупн: крупных крупного крупной
ещ: ещ
един: единого
процесс: процесса процессы процесс процессов процессе процессу
внесен: внесения
лес: лес
гриб: грибы
дом: домой
скатерт: скатертью
самобранк: самобранкой
навязыва: навязывать
ид: идеи
необходим: необходимо необходимость
выстро: выстроить выстроили
состав: составить
набор: набор
базов: базовых базовую базовой
требован: требований требования требованиям
договор: договориться
участник: участниками участникам
цикл: цикла цикл
долж: должен
механизм: механизм
нек: некий
позволя: позволяющий
прозрачн: прозрачный
пут: путь путем
показа: показать показаться показало
полезн: полезность полезных
автоматизац: автоматизации автоматизация автоматизацию автоматизацией
использован: использованием использовании
метрик: метрик
основ: основе
расскаж: расскажу
внедря: внедряли
как: каким какие какое
результат: результатам результатов
привел: привело
пройд: пройд
появлен: появления
осяза: осязаемых
уч: уч
трудност: трудностей
внедрен: внедрения
побочн: побочных
врод: вроде
старт: старте
работ: работе работы работу работ работа
вендор: вендорами вендоров
окуна: окунайтесь
глубж: глубже
гибридн: гибридные гибридной
команд: команды команде команда команду команд командой командами
рол: роль роли
способ: способы
эффективн: эффективных
коммуникац: коммуникаций коммуникация коммуникации
билайн: билайн
персонал: персоналом
карьер: карьера
индустр: индустрии индустрия
правильн: правильная правильный
главн: главных главной главное
фактор: факторов фактор
успех: успеха
прова: провала
продуктов: продуктовой
поддержк: поддержки поддержка
функциона: функционала функционал
вовс: вовсе
очевидн: очевидна
взгляд: взгляд
участв: участвуют
разн: разные разным
опыт: опыту опытом опыта
должност: должности должность
темперамент: темпераменту
характер: характеру
специалист: специалисты
основн: основные основной
внутр: внутри
сравн: сравним сравнить
исход: исходя
метод: метода методы
форм: формы форме
передач: передачи
реч: речь
идет: идет
электрон: электронных
письм: письмах
чат: чатах
виде: видео
ауд: аудио
конференц: конференциях
реж: реже
очн: очных
встреч: встречах
итак: итак
порядк: порядку
истор: истории историю
втор: втором
раздел: разделе разделились разделы
описа: описал
качеств: качестве качества
ключев: ключевой ключевым
первичн: первичной
сущност: сущности сущностью сущностей
предыдущ: предыдущей
обознач: обозначил
явля: является
квинтэссенц: квинтэссенцией квинтэссенция
посмотрет: посмотреть
призм: призму
выстраива: выстраивается
общ: общую общем
гармоничн: гармоничную
логик: логику
стройн: стройную
упз: упз
функционир: функционирующую
технолог: технологии технологиях
туз: туз
хоч: хочу
обобщ: обобщить
обсуд: обсудить
вопрос: вопрос вопросах вопросы вопросами вопросу
сдела: сделаю сделав сделать сделали сделал
дат: дать
комплексн: комплексное
обзорн: обзорное
представлен: представление
ракурс: ракурс
позвол: позволит
разреш: разрешить
мног: многие многое многих
проблем: проблемы
над: надеюсь
благодар: благодаря
мо: моему мо
акцент: акценту акцент
появ: появится
полн: полное
пониман: понимание
осознан: осознание
концентрирова: концентрироваться
слов: словом
начн: начн
апр: апр
рев: ревью
тз: тз
углублен: углубленная
туториа: туториал
рассмотрел: рассмотрели
собра: собрать
документац: документации
этап: этапе этапы
облегча: облегчает
аналитик: аналитику аналитика
появля: появляются
шир: шире
придума: придумать
удобн: удобнее
оптимальн: оптимально
совет: советую
прочита: прочитать
анализ: анализ
проработа: проработав
пар: пару
месяц: месяцев месяц
нача: начал
ощуща: ощущать
неудобн: неудобные
мест: места место
прос: просят
фиксирова: фиксированной
цен: цене
фактическ: фактически
затрачен: затраченному
дел: делимся
сво: своим своими
модел: моделям модели
продаж: продажами
финанс: финансы
кейс: кейс
приня: приняла
мигрирова: мигрировать
стал: стало стали
наш: наших нашим нашего
заказчик: заказчиков заказчика
заодн: заодно
преимуществ: преимущества
недостатк: недостатки
кажд: каждой каждого
максимальн: максимально
нивелирова: нивелировать
обнаглел: обнаглели
уход: ухода
взял: взялись взял
импортозамещен: импортозамещению
продукт: продуктов продукта продуктом продукты продуктах продукт продуктами
ран: ранее ранний
замен: заменили замене
пришл: пришла пришлось
очеред: очередь
друг: другого другом
рассказа: рассказать
успел: успели
альф: альфа
верс: версию
сообществ: сообщества
официальн: официальный
релиз: релиз
прод: проде
аналог: аналога
обычн: обычной
котор: котором которыми которое которому
писа: писали писал
напорол: напоролись
пробл: проблему
переучива: переучиваться
интерфейс: интерфейс
реш: решили
пойт: пойти
выигрышн: выигрышным
привычн: привычный
сраз: сразу
закладыв: закладывая
возможн: возможности возможность
дальн: дальнейшего
расширен: расширения
дво: двоих
тимлид: тимлидом
газпромбанк: газпромбанк
найт: найти
руководител: руководителя руководителей руководитель руководителю руководителями руководителем руководители
направлен: направление
подход: подходят подход подходов
человек: человека
хорош: хорошие хорош хорошего
имеют: имеют
проектн: проектный проектного проектным
оп: опыт
техническ: технические техническая
хот: хотят
раст: расти
предполож: предположить
незнаком: незнакомым
ч: ч
одн: одном одна одних
поступа: поступать
фреймворк: фреймворками фреймворков фреймворка
выписа: выписать
оценива: оценивать
важност: важность
взвешен: взвешенную
итогов: итоговую
момент: момент моментов моменты
ищ: ищем
супергеро: супергероев
нужн: нужны
соответств: соответствуют соответствии
станов: становится
нуж: нужен
факт: факт
точн: точный точно точным
хотел: хотел
поня: понял
ситуац: ситуациях
инструкц: инструкция
менеджер: менеджеров менеджером менеджеру менеджер
реанимац: реанимации
учебн: учебный
привет: привет
вик: вика
строгонов: строгонова
офис: офиса офисом
идеальн: идеальном
выполня: выполняются выполнять
срок: срок сроки
бюджет: бюджетом бюджет
заран: заранее
определен: определенными определение определения определению
ресурс: ресурсами
уровн: уровнем
реальност: реальности
случ: случиться
реализац: реализации реализацию
забрел: забрела
начина: начинает начиналось начинается
пахнут: пахнуть
жарен: жареным
переда: передать
комплект: комплекте
доста: достаться
наследств: наследство
сотрудник: сотрудника сотрудников сотрудники
материал: материале
пойдет: пойдет
плох: плохо
перв: первую первые
обрат: обратить обратил
вниман: внимание
звоночк: звоночки
продакт: продакт продакта
терминолог: терминология
стартап: стартапа стартап стартапам
меня: менял менялась
проход: проходил проходили
собеседован: собеседования
навык: навыки
особен: особенности
занима: занимался
каса: касались
экономик: экономики
взаимодейств: взаимодействия
поскольк: поскольку
специфич: специфичен
закра: закралось
сомнен: сомнение
размышля: размышлять
откуд: откуда
род: родился
написа: написано
владельц: владельцем
рассказыва: рассказывают
приложен: приложениях приложение приложений
вызов: вызова
такс: такси
агрегатор: агрегаторах
объявлен: объявлений
социальн: социальных
сет: сетях
интернет: интернет интернете
магазин: магазинах
рассказ: рассказ
сот: сотен
крут: круто
ход: ходов
мов: мов
обход: обходят
сторон: стороной сторона сторону стороны
существ: существуют
горазд: гораздо
меньш: меньшего
польз: пользуются
дела: делают делать делаете делается
классн: классные
успешн: успешные
говор: говорю говоря говорим
внутрен: внутренних внутренние
зовут: зовут
денис: денис
солов: соловьев
получ: получилось получили
продолжа: продолжаю
выраст: вырастить
отдел: отделов отделы отдел отделить
линейн: линейных
читальн: читальный
зал: зал
артур: артур
руковож: руковожу
сказбук: сказбуке
разрабатыва: разрабатываем
мобильн: мобильное мобильных мобильной
игров: игровой
мышлен: мышление
талант: таланты
ребенк: ребенка
претерпел: претерпел
множеств: множество
внешн: внешняя
прич: причем
кардинальн: кардинально
совпа: совпал
очередн: очередным
перестроен: перестроением перестроения
организацион: организационной
структур: структуры
маленьк: маленьких маленькой
некотор: некоторым
управленческ: управленческого управленческие
заня: занять
созда: создать создано создается
атмосфер: атмосферу
услов: условия
исполнител: исполнителями
приобрел: приобрели
увеличен: увеличения
объем: объема
контент: контента
игр: игры игрой
стара: старались
выпуска: выпускать
недел: недели
отдельн: отдельная отдельных
отвеча: отвечали
юн: юнит
коротк: короткие
концепт: концепта
финальн: финального
публикац: публикации
росс: россии
график: графиками графиков
цифр: цифрами
посвяща: посвящается
надеет: надеется
побыстр: побыстрее
бесплатн: бесплатная
самозанят: самозанятых
откровен: откровенно откровенного
нул: нуля
стабильн: стабильной
выручк: выручки выручка выручку
рубл: рублей
венчурн: венчурных
инвестиц: инвестиций
платн: платной
реклам: рекламы рекламу реклама
скучн: скучно
скромн: скромной
раду: радуемся
дет: дети
быстр: быстро
макс: максим
кульгин: кульгин
защит: защита защиты
скликиван: скликивания
яндекс: яндекс
директ: директ
март: марте
рекордн: рекордную
молод: молодой
подел: поделюсь
значим: значимых
вид: виде
пункт: пунктов
получа: получается
системн: системно системное
выдел: выделить
скаж: скажу
улучша: улучшать
фронт: фронтам
алгоритм: алгоритмам
сайт: сайта
кабинет: кабинет
отчет: отчетам
п: п
бесконечн: бесконечный
улучшен: улучшения
видн: видно
конц: конца конце
кра: края
средств: средства
мягк: мягко
домен: доменное
зарегистрирова: зарегистрировали
сут: сути
активн: активно
октябр: октябре
грант: грант гранта
фси: фси
млн: млн
руб: руб
трат: тратить
фот: фот
резидент: резидентом
сколков: сколково
ускор: ускорило
смогл: смогли
усил: усилить
разработчик: разработчиков разработчика
математик: математиков
обнаружен: обнаружение обнаружения
бот: ботов
скликива: скликивают
исключительн: исключительно
математическ: математическая
и: ии
аномал: аномалий
движен: движениях
мышк: мышки
детальн: детальный
разбор: разбором
заявк: заявки
реза: резать
убир: убирая
лишн: лишние
территор: территории
бывш: бывшего
ссср: ссср
популярн: популярной
методолог: методологией методологий методологию
сред: среди
люб: любых любыми
гибк: гибких
вариац: вариаций
итерацион: итерационных
производствен: производственных
парадигм: парадигм парадигмы
научн: научные
исследован: исследования
консультант: консультантов
последовательн: последовательно
наращива: наращивал
востребован: востребованность
явн: явно
доминир: доминирует
част: часть
вызыва: вызывают
энтузиазм: энтузиазма
организац: организациях
например: например
вообщ: вообще
внедр: внедрены внедрить
нигд: нигде
субъективн: субъективных
ощущен: ощущений
генеральн: генеральных
директор: директоров
студ: студий
российск: российских российской
софтверн: софтверных
обеспечен: обеспечения обеспечение
критер: критериев
точк: точки
зрен: зрения
оптимизац: оптимизации
продуктивн: продуктивности
загрузк: загрузки
безусловн: безусловно
оста: остаются
цел: целые целом цели
област: области областях
отрасл: отрасли отрасль
инженер: инженеры инженерии
знают: знают
честн: честны
х: х
год: годов годы
век: века век
могл: могло
сам: самые
самолет: самолетов
ракет: ракет
станк: станков
превосходн: превосходно
помн: помнят
й: й
коммерческ: коммерческая
выбра: выбрала
преодолева: преодолевает
разнообразн: разнообразные
регулярн: регулярно
возника: возникающих
снижа: снижать
себестоим: себестоимость
тяжел: тяжелые
врем: времена
узна: узнать
непрям: непрямое
чуж: чужой
ваш: вашей
инфосистем: инфосистемы
джет: джет
желез: железо
смигрирова: смигрировать
постро: построить
резервн: резервный
цод: цод
хочет: хочет
сил: силами сил
причин: причинам
представьт: представьте
эмоц: эмоции
люд: людей
банк: банке
систем: системе системы
установлен: установленной
физическ: физическом
сервер: сервере сервер
даунтайм: даунтайм
согласова: согласовать
план: план плане
остановк: остановки
миграц: миграции
облак: облако
контейнер: контейнер
желан: желания
отмахнут: отмахнуться
страх: страха
непониман: непонимания
нелюбв: нелюбви
восприят: восприятия
помех: помехи
гор: горят
вещ: вещи
пойд: пойд
легч: легче
безболезнен: безболезненнее
называ: называется
шли: шли
навстреч: навстречу
практик: практике
равн: равно
управля: управлять
инфраструктур: инфраструктурой
подразделен: подразделения
принцип: принцип
выживан: выживания
недавн: недавнем
перенос: переносили
соответствен: соответственно
обща: общались
нескольк: несколькими
десятк: десятками
провож: провожу
онбординг: онбординг
потрат: потратил
стольк: столько
уш: уш
л: л
помогл: помогли
пониз: понизить
текучест: текучесть
кадр: кадров
отвлека: отвлекаться
кандидат: кандидатов
миллион: миллион
доллар: долларов
бэкап: бэкапов
раз: разу
использова: использовал использовать использовали
хранен: хранение
перевод: перевод
видеоигр: видеоигр
стран: странное странно
одновремен: одновременно
отстава: отставать
остальн: остальной
технологическ: технологической
полдесятк: полдесятка
опережа: опережать
привлекл: привлекла
развлекательн: развлекательными
создан: создания
понрав: понравится
мог: могу
назва: назвать
геймер: геймером
любл: люблю
реша: решать
нелегк: нелегко
приш: приш
назнач: назначили
программирован: программирования
ужасн: ужасно
горизонт: горизонте
остава: оставался
крайн: крайне
сыр: сырым
нативн: нативные
двоичн: двоичные
файл: файлы
вмест: вместо
собствен: собственную
распредел: распредел
нных: нных
наличеств: наличествующий
действ: действующий
влия: влияющий
образ: образом
уловим: уловимый
замеча: замечаемый
учитыва: учитываемый
принима: принимаемый
расч: расч
назван: названия
парадокс: парадокс
заключа: заключается
вста: вста
обнаруж: обнаружил
иска: искал
наход: находил
взят: взять
имеющ: имеющееся
понят: понятие
дума: думал
сход: сходит
уст: уст
применя: применяют
каков: каково
удивлен: удивление
смог: смог
однозначн: однозначного
тко: тко
идентифицирова: идентифицировать
указа: указанной
разобра: разобрал
может: можете
почита: почитать
ус: ус
намота: намотал
отмет: отметил
неспрост: неспроста
отлича: отличается
задава: задавался
постоя: постоянно
фраз: фразы
постав: поставил
озадач: озадачил
подчин: подчин
нног: нного
выполнен: выполнение
лиш: лишить
прем: премии
невыполнен: невыполнение
осозна: осознают
оперир: оперируют
архитектур: архитектура
садовод: садоводов
визуализац: визуализация
грустн: грустное
рычан: рычание
бодр: бодрое
мычан: мычание
дружеск: дружеское
ржан: ржание
рожда: рождается
свет: свет света
скелет: скелет
огромн: огромный
шум: шума
настоя: настоящее
эфирн: эфирного
посвящ: посвящено
обсужден: обсуждению
различн: различных различными
достоинств: достоинств
масштабирован: масштабирования
ведущ: ведущих
комментир: комментирующих
либ: либо
реальн: реального
огн: огня
времен: временами
свалива: сваливаемся
обратн: обратно
войн: войн
группировк: группировками
любим: любимые
бумаг: бумаге
дин: дина дином
леффингвелл: леффингвелла
формализова: формализован
руководств: руководства
многонациональн: многонациональной
связ: связи
помог: помогая
определ: определить
планирован: планированию
эволюционирова: эволюционировало
сюд: сюда
вклад: вклад
ваканс: вакансии
аккаунт: аккаунт
войт: войти
регистрац: регистрация
хаб: хабы
устройств: устройство
документ: документы
соглашен: соглашение
конфиденциальн: конфиденциальность
услуг: услуги
корпоративн: корпоративный
медийн: медийная
образовательн: образовательные
программ: программы
спецпроект: спецпроекты
дзен: дзен
настройк: настройка
язык: языка
вернут: вернуться
стар: старую
rss: rss
renew: renewal
studio: studio
agil: agile
psurakshin: psurakshin
po: pos
face: face
id: id
darkbenladan: darkbenladan
devop: devops
govern: governance
enterpris: enterprise
recoveri: recovery
mode: mode
yuvmichurin: yuvmichurin
motaev: motaev
x: x
anana: ananas
na: na
pririod: pririode
comala: comala
confluenc: confluence
sportmast: sportmaster
lab: lab
atlassian: atlassian
vilkhovskii: vilkhovskiy
evateam: evateam
jira: jira
servic: service
manag: management
desk: desk
evaservicedesk: evaservicedesk
commun: community
moscow: moscow
shoview: shoview
vctrog: vctrog
kt: kts
polybot: polybot
ozon: ozon
tech: tech
arturmkrtychan: arturmkrtychan
makasin: makasin
ik: ik
saa: saas
offlinecrm: offlinecrm
crm: crm
chatgpt: chatgpt
clickfraud: clickfraud
ru: ru
ux: ux
ui: ui
ssconsult: ssconsulting
scrum: scrum
ssc: ssc
xp: xp
kanban: kanban
web: web
jethabr: jethabr
dreikaaa: dreikaaa
vd: vds
ruvd: ruvds
ubisoft: ubisoft
op: ops
window: windows
kubernet: kubernetes
docker: docker
itguevara: itguevara
architectur: architecture
mgvoronin: mgvoronin
safe: safe
scale: scaled scale
framework: framework
http: http
www: www
scaledagileframework: scaledagileframework
larg: large
craiglarman: craiglarman
dean: dean
leffingwel: leffingwell
releas: release
train: train
art: art
milfgard: milfgard
nmivan: nmivan
ntsaplin: ntsaplin
elena: elena
pastukhova: pastukhova
m: m
rko: rko
axelu: axelus
cord: cord
roma: romas
novikov: novikov
facebook: facebook
twitter: twitter
vk: vk
telegram: telegram
youtub: youtube
habr: habr
