хабр: хабр
откр: открыть
список: список
стат: стать статьи статье статься статей статья статьях
автор: автором авторы автор авторов
поток: потоки
разработк: разработка
администрирован: администрирование
дизайн: дизайн
менеджмент: менеджмент
маркетинг: маркетинг
научпоп: научпоп
поиск: поиск поиска
профил: профиль
обнов: обновить
рейтинг: рейтинг рейтинга
формальн: формальный
непроцедурн: непроцедурный
язык: язык языка языков
программирован: программирования программирование
компан: компании компаниями компаний
подряд: подряд
скопирова: скопировать
ссылк: ссылку
показыва: показывать
нов: новые нового новых
лучш: лучшие лучших
порог: порог
уровен: уровень
сложност: сложности
прост: простой
средн: средний
сложн: сложный сложно сложных
примен: применить
час: часа часов
аналитик: аналитиком аналитика аналитике аналитики аналитик аналитиков аналитику
дан: данных данном данными данным данные
прочтен: прочтение
мин: мин
количеств: количество
просмотр: просмотров
анализ: анализ анализом анализа
проектирован: проектирование
сист: систем
учебн: учебный
процесс: процесс процессы
карьер: карьера карьеры
индустр: индустрии
роадмэп: роадмэп
современ: современном современным
мир: мире
представля: представляет
одн: одну одним
востребова: востребованных
перспективн: перспективных
професс: профессий
больш: большое большую
котор: которое которым
генерир: генерируется
использ: используется
различн: различных различные
отрасл: отраслях
став: ставит
организац: организациями
задач: задачу задачах задачи задач
высококвалифицирова: высококвалифицированных
специалист: специалистов специалистам специалист
способн: способных
обрабатыва: обрабатывать
анализирова: анализировать
информац: информацию информации информация
рассмотр: рассмотрим
как: какие какими какого каких какое
требован: требования требований
предъявля: предъявляются
сфер: сфере
навык: навыками навыки навыка
знан: знаниями знания знаний знание
облада: обладать
успешн: успешной
чита: читать
дал: далее
голос: голосов
добав: добавить
закладк: закладки
комментар: комментарии
новост: новости
сдела: сделать
блог: блог
перевод: перевод
виртуальн: виртуальные
файл: файлы файлов файл файла
журнал: журналов журналом
внутрен: внутреннее
разбиен: разбиение
реальн: реальных
физическ: физических физический
созда: создает создаются создан создал
работ: работы работе работа
транзакц: транзакций
четк: четко
определен: определенного определения
размер: размера размер размеров
явля: является являются
фиксирова: фиксированным
компонент: компонентом компонентов
создан: создания
расширен: расширения
рассчитыва: рассчитывается
динамическ: динамически
основ: основе основы
существ: существующего существующих существующими
журна: журнала
приращен: приращения
числ: числится числа
дурн: дурная
слав: слава
заключа: заключается
вызва: вызвать
ряд: ряд ряду
пробл: проблем
сред: среди
выдел: выделить
существен: существенное
снижен: снижение
скорост: скорости
запуск: запуска
баз: базы баз базами базе базах
операц: операции операцию
резервн: резервного
копирован: копирования
восстановлен: восстановления
сгененрирова: сгененрировано
дольш: дольше
привест: привести
превышен: превышению
ожидан: ожидания
ошибк: ошибкам ошибки
связа: связанным связанных связанная
памят: памятью
цел: целому целого целой целей цель
проблем: проблемам проблемы проблема
апр: апр
инъекц: инъекции инъекций инъекция
сам: самых самое
маленьк: маленьких
част: часть части
запрос: запросы запросов запроса
информацион: информационная
безопасн: безопасность безопасности безопасными безопасно безопасная безопасного
терминолог: терминология
втор: вторая
счет: счету
цикл: цикла
особен: особенности
использован: использовании использование использования
команд: команды команда
дублирован: дублирование дублирования
ограничен: ограничений ограничения
контрол: контролей
уровн: уровне уровня уровню
бд: бд
кейс: кейс
сторон: стороне сторон
так: таких таким
внешн: внешние внешнего
ключ: ключи
проверк: проверки
значен: значений значение значения
уникальн: уникальности
вызыва: вызывают
спор: споры
разработчик: разработчиков разработчику
аргуммент: аргумменты
обе: обеих
известн: известны
пример: пример примерами примеры
применя: применяются применяем
реализ: реализуют
дополнительн: дополнительную дополнительных
логик: логику
помощ: помощью
некотор: некоторых некоторые
подробн: подробнее
истор: истории история
интересн: интересных интересные интересна интересное
песочниц: песочницы песочница
добр: доброго
дня: дня
иска: искать
освеж: освежить
немал: немалому
удивлен: удивлению
обнаруж: обнаружил
несмотр: несмотря
очевидн: очевидную
востребован: востребованность
тем: темы
набор: наборы наборов
русскоязычн: русскоязычных
ресурс: ресурсах ресурсов
пересчита: пересчитать
пальц: пальцам
хоч: хочу
подел: поделиться поделюсь
сообществ: сообществом
сво: своим свой сво
мнен: мнением мнение
повод: поводу
отлич: отличие
авторск: авторские
решен: решения решение
понрав: понравились
мар: мар
измерен: измерение
влиян: влияния
производительн: производительность производительности
задава: задавались
вопрос: вопросом
наскольк: насколько
влия: влияют
ваш: вашей вашу
рабоч: рабочей рабочий
нагрузк: нагрузки
писа: писал
активн: активным активных
сторонник: сторонником
качеств: качестве
альтернатив: альтернативы
работа: работаю работать
дают: дают
множеств: множество
преимуществ: преимуществ
сбор: сборе
минимальн: минимальными
накладн: накладными накладных
расход: расходами расходов
быва: бывают
случа: случаи случаях случае случаев
обойт: обойтись
наблюден: наблюдение
ультимативн: ультимативная
дорожн: дорожная
карт: карта карт
изучен: изучения изучение изучении
источник: источники источников источника
поможет: поможет
науч: научиться
настоя: настоящим настоящих
эксперт: экспертом
практикова: практиковаться
изуча: изучать изучает
аспект: аспекты
протяжен: протяжении
мног: многих многие многое
предлага: предлагает
отличн: отличный
старт: старт
поэт: поэтому
рекоменд: рекомендую
приступ: приступить
обучен: обучению
согласн: согласно
план: плану
необходим: необходимо
кажд: каждому
туториа: туториал
специальн: специальное
обозначен: обозначения
отсутств: отсутствия отсутствие
отлича: отличается
пуст: пустой
строк: строки
нулев: нулевого
означа: означает означало
либ: либо
ячейк: ячейке
таблиц: таблицы таблицах таблице таблиц
появлен: появления
длин: длинна
начал: начале
х: х
год: годов годы
д: д
камерер: камерер
р: р
бойд: бойд
предлож: предложили
использова: использовать использован
реляцион: реляционную реляционной
модел: модель моделей модели
полн: полной полная
зам: замены замена
иерархическ: иерархических
сетев: сетевых
актуальн: актуальны актуальный
предполага: предполагала
возможн: возможность
хранен: хранения хранение
структур: структуры структуру
первоначальн: первоначально
интегральн: интегральный
элемент: элемент
люб: любого любые любом любой
тип: типа
например: например
неизвестн: неизвестно
разработа: разработана
реализова: реализован
маркер: маркер
указыва: указывает
столбц: столбце
образ: образом
неопределен: неопределенное неопределенный
выполня: выполняете
содержа: содержащем
результат: результат результатам
привод: приводить
нежелательн: нежелательным
непредсказуем: непредсказуемое
поведен: поведение поведении
важн: важно
понима: понимать
обязательн: обязательно обязательного
разн: разных разные
указан: указание
вычислен: вычислений
отметк: отметки
оста: остается
популярн: популярных
используем: используемых
област: области
полезн: полезным
начина: начинает
пут: путь пути
опытн: опытных
профессионал: профессионалов
хот: хотят
расшир: расширить
совет: советов
помогут: помогут
остава: оставаться
курс: курсе
последн: последних последние
тенденц: тенденций
изменен: изменений изменения
сайт: сайта
кандидат: кандидатам
ваканс: вакансиях вакансий вакансии
включа: включают
зарплат: зарплата
владеющ: владеющих
составля: составлять
зависим: зависимости
регион: региона
опыт: опыта опытом
связ: связи
хочет: хочет
улучш: улучшить
шанс: шансы
рынк: рынке
труд: труда
получа: получать
высок: высокую высоко высокая
заработн: заработную
плат: плату
тестирован: тестирование
веб: веб
сервис: сервисов
переход: переходим
техническ: технической техническая
проникновен: проникновение
начн: начнем
эксплуатац: эксплуатации
уязвим: уязвимостей уязвимость уязвимости уязвимостями
позволя: позволяет позволяют
злоумышленник: злоумышленнику злоумышленник
вмешива: вмешиваться
приложен: приложение приложения приложений
дела: делает делают делать делаем
прав: правило
просматрива: просматривать
получ: получить
пользовател: пользователей пользователю
доступ: доступ
имеет: имеет
изменя: изменять
удаля: удалять удаляйте
вызыв: вызывая
постоя: постоянные
содержим: содержимом
дефрагментац: дефрагментация дефрагментацию
нагружен: нагруженных
серверн: серверная
оптимизац: оптимизация
небольш: небольшие
сотн: сотни
гигабайт: гигабайт
ноч: ночью
выходн: выходные
может: можете
позвол: позволить позволит
дефрагментирова: дефрагментировать
терабайт: терабайт терабайты
заня: занять
дни: дни
существован: существование
станов: становится
непринципиальн: непринципиальным
деятельн: деятельность
процессинг: процессингом
принцип: принципе
разумеет: разумеется
миф: миф
нужн: нужна
систем: системах системы
итог: итоге
процент: процент
фрагментац: фрагментации
выход: выходит
занима: занимают
раз: раза
страниц: страниц страницы
мест: места
хуж: хуже
выш: выше
перемеща: перемещаются
процессор: процессора
генерац: генерация генерации
творчеств: творчество
рутин: рутина
обзор: обзор
долг: долгие
стрем: стремились
вс: вс
реалистичн: реалистичному
изображен: изображению
окружа: окружающих
вещ: вещей
прошл: прошло
симпатичн: симпатичных
наскальн: наскальных
мамонт: мамонтов
шедевр: шедевров шедевра
эпох: эпохи
ренессанс: ренессанса
просвещен: просвещения
век: веке
примерн: примерно
стал: стала
появля: появляться
перв: первая первом первых
фототехник: фототехника
аг: ага
пошл: пошло
живоп: живопись
смен: сменила
направлен: направление направления
реализм: реализма
абстракц: абстракции
скат: скатилось
клякс: клякс
пят: пятен пяти
пот: пот
ков: ков
размаза: размазанных
холст: холсту
поверхн: поверхности
стоимост: стоимостью
миллион: миллионы
доллар: долларов
зачаст: зачастую
совершен: совершенно
непонятн: непонятно
летн: летний
ребенок: ребенок
мастит: маститый
художник: художник
нейросет: нейросеть
кот: кот
опрокинувш: опрокинувший
банк: банку
варен: варенья
похож: похожие
происход: происходят
синтетическ: синтетические
сгенерирова: сгенерированные
абстрактн: абстрактные
обрета: обретают
ценност: ценность
тестирова: тестировать
качествен: качественнее
воспроизвод: воспроизводить
продакшен: продакшене
прогноз: прогнозы
обменива: обмениваться
пост: посте
основн: основные основном основная
момент: моменты
нул: нуля
схем: схемы
способ: способы способом способа
метод: методы
инструмент: инструменты
шаг: шаг
иллюстрирова: иллюстрировать
жив: живых
постара: постараемся
убед: убедимся
эффективн: эффективно эффективную
минуточк: минуточку
эффектн: эффектно
придумыва: придумывать
сер: серый серии
кардина: кардинал
программист: программистам
яндекс: яндекс
практикум: практикум практикума
исследован: исследования исследование исследований
описыва: описывает
скилсет: скилсет
структурирова: структурированных
исследовател: исследователей
изуч: изучила
текущ: текущие
выясн: выяснили
действ: действующих
нуж: нужен
конкретн: конкретно конкретной
желательн: желательно
подтянут: подтянуть
легч: легче
войт: войти
времен: временные
умоля: умоляю
опасн: опасном
распространя: распространяющемся
антипаттерн: антипаттерне
распространен: распространенных
написа: написано
друг: другого
познаком: познакомиться познакомимся
типичн: типичными
разобра: разобрать
практик: практики
кодирован: кодирования
ошибок: ошибок
допуска: допускает
стара: старается
исправ: исправить
помога: помогает
погруз: погрузиться
вперв: впервые
код: кода
понят: понятия
рассчита: рассчитана
новичк: новичков
предыстор: предыстория
отч: отч
директор: директора директор
умеет: умеет
программирова: программировать
подключа: подключается
инструкц: инструкции
треб: требует
срочн: срочно
объ: объем
выручк: выручки
продаж: продаж
затрат: затраты
персона: персонал
битрикс: битрикс
обработк: обработки
заявок: заявок
инженер: инженеру инженер инженеров
добавлен: добавление
единствен: единственный
офис: офисе
критическ: критически
оценива: оценивает
срок: сроки срок
выполнен: выполнения
объявля: объявляет
минимум: минимум
недел: недели
устраива: устраивает
альтернативн: альтернативное
фев: фев
выбра: выбрать
конвейер: конвейера конвейеров
максимальн: максимально
архитектур: архитектуру архитектуры
билайн: билайн
привет: привет
зовут: зовут
миха: михаил
благ: благов
руководител: руководитель
департамент: департамента
чаптер: чаптер
подходя: подходящую
частност: частности
обсуд: обсудим
паттерн: паттерн
захват: захват
иде: идея
быстр: быстрая быстрого быстрый
репликац: репликация
аналитическ: аналитическое
хранилищ: хранилище хранилищ хранилищах хранилища
кат: катом
вариант: вариантами
собира: собирать
сравн: сравним
серебрян: серебряной
пул: пули
выбор: выбора выбор
аналогичн: аналогичный
потреб: потребует
замер: замеров
матчаст: матчасти
крупиц: крупицы
золот: золота
реестр: реестре реестра
тензор: тензор
алгоритм: алгоритмы
большинств: большинстве
учетн: учетных
наш: нашего нашем
сбис: сбис
поздн: поздно
возника: возникает
отображен: отображения
просьб: просьбам
бизнес: бизнес
накруч: накручено
комбинируем: комбинируемых
фильтр: фильтров
редк: редкой
выборк: выборкой
никак: никак
ложа: ложащихся
красив: красивую
индекс: индексов
базов: базовой
покупател: покупателям
че: чей
рожден: рождения
выпада: выпадает
феврал: февраля
универсальн: универсального
расскаж: расскажу
дат: дать
отклик: отклик
весьм: весьма
точк: точки
зрен: зрения
коммитфест: коммитфест коммитфестов
продолжа: продолжаем
след: следить
новинк: новинками
й: й
верс: версии версию
заверш: завершился
ждет: ждет
вперед: впереди
напомн: напомню
трех: трех
прочита: прочитать
предыдущ: предыдущих
труъ: труъ
почтатех: почтатех почтатехе
стандарт: стандарты
васил: василий
причиня: причиняю
полтор: полтора
руковож: руковожу
групп: группой
автоматизац: автоматизации
петабайт: петабайт
представ: представить
масштаб: масштабы
реч: речь
идет: идет
почт: почте
росс: россии
логистик: логистика
трейсинг: трейсинг
посылок: посылок
строительств: строительство
сортировочн: сортировочных
центр: центров
основыва: основываются
объем: объемах
внедр: внедрить
подобн: подобное
сюд: сюда
вклад: вклад
аккаунт: аккаунт
регистрац: регистрация
раздел: разделы
хаб: хабы
устройств: устройство
документ: документы
соглашен: соглашение
конфиденциальн: конфиденциальность
услуг: услуги
корпоративн: корпоративный
медийн: медийная
реклам: реклама
нативн: нативные
проект: проекты
образовательн: образовательные
программ: программы
стартап: стартапам
спецпроект: спецпроекты
дзен: дзен
настройк: настройка
поддержк: поддержка
вернут: вернуться
стар: старую
sql: sql
rss: rss
badcasedaili: badcasedaily
python: python
maxrokatanski: maxrokatansky
server: server
vlf: vlf
otu: otus
virtual: virtual
log: log
file: files
databas: database
engin: engine engineering
uhahatbl: uhahatbl
tv: tv
union: union
ctf: ctf
nvv: nvv
postgresql: postgresql
shoenfield: shoenfield
sqlite: sqlite
extend: extended
event: events
trace: trace
sqlskill: sqlskills
data: data
mine: mining
big: big
roadmap: roadmap
null: null
d: d
chamberlin: chamberlin
r: r
boyc: boyce
structur: structured
queri: query
languag: language
develop: developer
analyst: analyst
administr: administrator
busi: business
intellig: intelligence
glassdoor: glassdoor
sqli: sqli
tzimi: tzimie
mssql: mssql
microsoft: microsoft
mainten: maintenance
window: window windows
case: case
studi: study
enterpris: enterprise
edit: edition
alwayson: alwayson
ssd: ssd
buffer: buffer
cach: cache
hit: hits
ratio: ratio
full: full
backup: backups
tabl: table
scan: scans
cpu: cpu
mgramin: mgramin
devop: devops
flavour: flavour
chatgpt: chatgpt
ira: ira
t: t
andrei: andrey
biryukov: biryukov
java: java
linux: linux
aleksandra: aleksandra
belova: belova
sore: sore
bi: bi
abc: abc
sap: sap
hrlink: hrlink
vogal: vogal
beelin: beeline
tech: tech
cdc: cdc
chang: change
captur: capture
aka: aka
disclaim: disclaimer
kilor: kilor
howto: howto
pluzanov: pluzanov
postgr: postgres
profession: professional
servariu: servarius
jug: jug
ru: ru
group: group
warehous: warehouse
dwh: dwh
erogov: erogov
jobgemw: jobgemws
alandenton: alandenton
varanio: varanio
chemtech: chemtech
rdruzyagin: rdruzyagin
mosca: moscas
noraq: noraq
nalgeon: nalgeon
facebook: facebook
twitter: twitter
vk: vk
telegram: telegram
youtub: youtube
habr: habr
