хабр: хабр хабре
откр: открыть
список: список
стат: стать статьи крис немецкая грамин таких интересную
автор: автором н новости сайта
поток: потоки
разработк: разработка обновились
администрирован: администрирование
дизайн: дизайн
менеджмент: менеджмент
маркетинг: маркетинг
научпоп: научпоп
поиск: поиск
профил: профиль
обнов: обновить утилиты
рейтинг: рейтинг
разработчик: разработчик
субд: субд
час: часов
прочтен: прочтение
мин: мин
количеств: количество
просмотр: просмотров
блог: блог й кокетство
компан: компании авторов
дайджест: дайджест
конференц: конференции конференцию
приход: приходите
появ: появился появилась рассказывали
анонс: анонс громкие
описан: описанием
доклад: докладов доклада доклад докладе доклады статьями
сайт: сайте информация устройство
программ: программа классом образовательные
трудн: трудно
выбра: выбрать концов
протранслирова: протранслировать
сюд: сюда
пожал: пожалуй
пуст: пусть
блок: блок
посвящ: посвящ
нны: нный
миграц: миграции
послуша: послушаем
максим: максима
афиногенов: афиногенова
дмитр: дмитрия
умников: умникова
васил: василия
пучков: пучкова
лукойл: лукойл
технолог: технологии
антон: антона
немцев: немцева
нетрик: нетрика
владимир: владимира
сердюк: сердюка
альфред: альфреда
столяров: столярова
ел: елена
скворцов: скворцова
ит: ит задачами
экспертиз: экспертиза
расскажет: расскажет
макс: максим
емелин: емелин
применен: применении вступление
александр: александр
любушкин: любушкин
андр: андрей
чибук: чибук
форс: форс
телек: телеком
подел: поделятся добавьте
сво: своим свой делится появившемся
опыт: опытом
перенос: переноса
больш: больших типов содержащего хочет
объем: объемов
дан: данных соответствующей подменяющих
представ: представят представит
разработа: разработанную
утилит: утилиту модули
игор: игорь
мельник: мельников
новинк: новинку
пакет: пакеты
офлайн: офлайн
иностранец: иностранец
кристофер: кристофер
треверс: треверс треверсе
котор: которым которыми языках релизы
мног: многим избежать название
об: обе
сторон: стороны
атлантик: атлантики
извест: известен
лих: лихой
писа: писали
прошл: прошлом вещей
номер: номере
поговор: поговорит
сугуб: сугубо
технологическ: технологические
тем: темы кстати текстовых
сраз: сразу
онлайнов: онлайновый
ин: ино
участник: участник участнике
брюс: брюс
момджя: момджян
исполнител: исполнителе
запрос: запросов оптимизации происходит возрастом составить
онлайн: онлайн
ещ: ещ
иностра: иностранный иностранном
вигнешвара: вигнешваран
си: си
раздел: разделе замечание войти
репликац: репликация репликации
бэкап: бэкап
некотор: некоторые некоторых
интересн: интересных интересный дважды тема
историческ: исторических
уязвим: уязвимостей
сдела: сделает юшэ
бородин: бородин
яндекс: яндекс
облак: облако сущность
ива: иван
фролк: фролков
использован: использовании
различн: различных
верс: версий новой последняя старую
качеств: качестве
первичн: первичных
ключ: ключей
нов: нового отличия собственно проблемы
част: части
руд: рудом
тов: тов
передаст: передаст
привет: привет
встроен: встроенного база
мультимастер: мультимастера
сравнен: сравнение случае
двунаправлен: двунаправленной
ванил: ваниле
отдел: отдела
образован: образования
павел: павел
толмач: толмач
познаком: познакомимся
минут: минут
работа: работает рассказам
генетическ: генетический
оптимизатор: оптимизатор
финишн: финишной
прям: прямой
традицион: традиционный
обзор: обзор
новинок: новинок
павл: павла
лузанов: лузанова
открыва: открывать
разумеет: разумеется
астрономическ: астрономический
экстремальн: экстремальная
астроном: астрономия
липунов: липунова
пройд: пройд
го: го
ма: мая
хаасрод: хаасроде
брюссел: брюсселя
законч: закончен
регистрац: регистрация дата
продолжа: продолжается
докладчик: докладчики
объявл: объявлены
немецк: немецкий бали
эссен: эссене
июл: июля
вид: вид версии реализующие
реклам: рекламы медийная
организатор: организаторы
говор: говорят отличиях
заодн: заодно
сможет: сможете
съезд: съездить
то: той
недел: неделе персоны
подава: подавать
заявк: заявки
апрел: апреля
постер: постеры
вест: вести
пояснительн: пояснительную
работ: работу периоду быстродействием
зашл: зашла
реч: речь
крис: крисе посоветую статья
офлайнов: офлайновом
интерв: интервью
еженедельник: ним
персон: еженедельнике
андреас: недели сироштан
шербаум: андреаса андреас
фрагмент: шербаума
откуд: фрагменты
род: откуда найд
сша: родом
подростк: сша
мота: подростком
калифорн: мотался
мичиган: калифорнии
ют: мичигану
вашингтон: юте
штат: вашингтону
уеха: штату
границ: уехал
возвраща: границу
жил: возвращался
индонез: жил
швец: индонезии
герман: швеции
как: германии
пользует: какими
любим: пользуетесь
цен: любимая
счита: ценить задач
сильн: считаю
недооцен: сильно
расширяем: недооценили
софт: расширяемости
управлен: софта
баз: управления нужна экспортирует департамента построенного теги
единствен: базой
сравним: единственная
нужн: сравнимая десятичное
приложен: встроенная
секунд: приложение
сомнев: секунды
посовет: сомневаясь
человеческ: докладами отч
фактор: человеческом
высоконагружен: факторе
систем: высоконагруженных
взят: системах
вообщ: взять
тб: вообще
использова: тб
аналитик: использовать
реальн: аналитики произведение реальных
относ: реальном
период: относится
берлинск: работы
зна: берлинской
рассказ: знаем
бывш: работающих
коллег: бывших
артур: коллег трое
закиров: артура
например: закирова
возглавля: например
команд: возглавлял
постгресист: команду
примечательн: постгресистов
вещ: примечательную окружающих подобные
постгрессист: вещь
важн: постгрессиста
уч: важно
понятн: учиться
прим: понятно
редакц: прим
желан: редакции
способн: желание модель
дума: способность
дух: думать
формальн: духе
математическ: формальной реализуют
теор: математической
логик: теории
рсубд: логики
реализ: рсубд выда
модел: математические бессерверные
лучш: модели вс вр пользователь
пример: лучший
реализац: пример
математик: реализации понимаем
понима: математики
лежа: математику
смож: лежащую
избежа: сможем
ненужн: многих
пробл: ненужных
соцсет: проблем
предпосыла: соцсетей
тр: предпосылает
богатыр: тр
ч: богатырям
тко: ч
разделен: ткое
труд: разделение
продуктивн: труда
общен: продуктивное
фот: общение
дел: фото ладно лавина справляется субботние
собствен: своими библиотеке
кулинарн: собственными
шо: кулинарным
кухн: шоу
западн: кухня
суматр: западной
литовск: суматры
итальянск: литовская
планир: итальянская
яв: планируются
бал: ява
отлич: криса сказано
наслед: видов
изменен: наследуют сравнению
соответств: изменениям
случа: данном файла
предыдущ: изменения поместить бишон
забыва: предыдущей
закр: забывать
дыр: закрыли
безопасн: дыру
соответствен: безопасности
закрыт: соответственно
непосредствен: закрыта
сказа: непосредственно
унаследова: говорится
описа: унаследованные
замечан: описаны любопытное
выпуск: замечаниях ошибке
устра: выпуску
нна: устран
проблем: нная решало
сформулирова: проблема
технологичн: сформулирована
устранен: технологично
утечк: устранение
содержим: утечки
памят: содержимого
сбо: памяти
инициализац: сбоя
шифрован: инициализации
трафик: шифрования
библиотек: трафика справлялись
добавл: новое
параметр: добавлен
позволя: параметр
копирова: позволяющий
выгружа: копировать
значен: выгружать
тип: значения составного
размер: большого
улучш: размера
производительн: улучшена
ран: производительность
страда: ранее
многочислен: страдавшая
сброс: многочисленных
кеш: сбросов
устран: кеша
ошибк: устранена сообщая
сегментац: ошибка
могл: сегментации вежливостью
возника: могла
попытк: возникать
удал: попытке
отдельн: удалить
пол: отдельное
составн: поле
завершен: типа
автономн: завершения
транзакц: автономной
исправл: транзакции
связа: исправлена
значительн: связанная
потреблен: значительным
оптимизац: потреблением
содержа: запроса
подзапрос: большое
входя: подзапросов
модул: входящие
аноним: разработки
фейкер: анонимы пр рассказывает
класс: фейкеры
подменя: программ
анонимизац: данные статическая
закреп: анонимизации
словечк: закрепилось
борец: словечко
чистот: борец
русск: чистоту современном
язык: русского человеческих вопросы
утомля: языка
хейтер: утомляют
газлайтингер: хейтеры
пр: газлайтингеры
слов: фейкер ключевым
точн: слова
хвата: точно
современ: хватает
ладн: русском
анонимизатор: делу
экспортир: анонимизатор
анонимизиру: базу
статическ: анонимизируя
задач: анонимизация нехитрых первую языковыми
создател: задача переключением
рафаэл: создателя считает
юшэ: рафаэля
простеньк: сделать созда
легк: простенький
инсталируем: легко
инструмент: инсталируемый
конкурирова: инструмент
функциональн: конкурировать
существ: функциональности анонимайзер решение
последн: существующими
умеет: версия
выбира: умеет
столбц: выбирать отличной строк
зада: столбцы
функц: задать набором словам
пропуска: функцию
указа: пропускать
таблиц: указанные покажи
анонимизирова: таблицы импортировать
меня: анонимизировать
лока: менять
использ: локали код
импортирова: использует
файл: анонимизированный млн временного
конц: файл решений
страничк: конце
любопытн: странички
рад: раздел
затея: ради
анонимайзер: затеяли
понрав: существующие
разн: понравились
причин: разным
настраива: причинам
неуклюж: настраивать
нехитр: неуклюжий
вс: рафаэль
решен: лучшее обоих естественным
схем: существующих учебную случайных
отличн: схемой
назван: столбцами используются одно
символ: названиями
верхн: символы
регистр: верхнего
вал: регистра
прост: валится недостатки масштабироваться
ситуац: простых
сообщ: ситуациях
рассказыва: выпуске воспользовавшись
похож: сво человеки
богат: похожим
набор: богатым
зка: функций
жюл: зка
ру: жюльена
бет: руо
фаз: бета
расширен: фазе
основа: расширение
французск: основанное
происхожден: французского
польз: происхождения жизни
грамин: пользуется
нача: статье
так: началось
лавин: статей
груб: делятся
категор: грубо
одн: категории задействует пробовал
сочиня: одних
интегрирова: сочиняет
инфраструктур: интегрирован
тейдж: инфраструктуру
куммарикунтл: тейджа
хотел: куммарикунтла библиотекой
показа: хотел
хорош: показать
удоб: хорош
задейств: удобен
сущност: одну
происход: облаке
слон: запросы
посыла: слону
созд: посылаются
табличк: простенькую результате
имен: табличку
возраст: именем
покаж: запросами
чь: таблице
начина: чь
штук: начинается
справля: штука добавляло
перв: делить появляться пересказывая самые лучшем
помощ: задачу вопроса разминки
кодирован: помощь токенизации
развернут: кодировании
хел: развернуть главное
александер: хелены
цел: александер
помоч: целый
дебаж: помочь
дат: дебажить сайт
совет: дать вещи
исправлен: советы
ошибок: исправлению
определен: ошибок
потенциальн: определение
код: потенциальных иллюстраций
информац: кода сутки
синтаксис: информацией
ключев: синтаксису
превраща: функциям
результат: превращать нагрузку
отч: результаты
подключа: которому
догада: подключаются
главн: догадаться
обраща: хелена
подоба: обращается
вежлив: подобающей
состав: могли
сет: запрос вигнешаваран
охотн: сеть
начин: охотно
фраз: начиная
выд: фразу
джойн: виды
кстат: джойнов
наход: теме
хром: находит
авторств: хрома
видим: авторства
рауф: видимо
чебр: рауфа
неон: чебри тянутся
деятельн: неона
направлен: деятельность усилия
оформ: направлении
громк: оформившаяся
релиз: анонсы
конвертирова: которое
вопрос: конвертировать получить эмбединги
поясня: языке
сгенерирова: пояснять просит
спрашива: сгенерированный
повод: спрашивать
эндр: поводу
кейн: эндрю
н: кейна
прабин: автор
ахар: прабин
след: ахария
тянут: следы
соосновател: неону джозеф
стас: сооснователю дописывания
кельвич: стасу
чтен: кельвичу
диаграмм: чтения
последовательн: диаграммы
обм: последовательности
сообщен: обмена найти
иллюстрац: сообщениями
быстр: названии
бессерверн: быстрее
приня: способная
токен: принять
заработа: токенов
получ: заработало
вход: вопрос
генерирова: входе
эмбединг: генерировать дистанции
вычисл: помощи
дистанц: вычислить
вернут: эмбедингами поддержка
контекст: вернуть
пояснен: контекст
ответ: пояснения
использу: ответ
метод: используя
дописыван: методы
эффективн: стаса
алгоритм: эффективный
токенизац: алгоритм
пар: кодированием
байт: пар
ртка: байтов
токенайзер: ртка
известн: токенайзера стало
быстродейств: известного
естествен: работе привязываться
языков: естественно
коллект: итого
молод: коллектив
талантлив: молодых
сер: талантливых
зно: серь
инвестир: зно
усил: инвестирует
генерац: направление доверить
творчеств: генерация
рутин: творчество
написа: рутина
дважд: написал
текстов: статью
нагенер: интересная разбираться
разминк: нагенерил
слегк: помощью
пофилософствова: слегка
долг: пофилософствовал
год: долгие
стрем: годы
реалистичн: стремились стохастически
изображен: реалистичному
окружа: изображению
симпатичн: прошло
наскальн: симпатичных
мамонт: наскальных реалистичная
шедевр: мамонтов непонятно
эпох: шедевров
ренессанс: эпохи
просвещен: ренессанса
век: просвещения
примерн: веке
стал: примерно читать
появля: стала
фототехник: первая
аг: фототехника
пошл: ага
живоп: пошло
смен: живопись
реализм: сменила
абстракц: реализма
скат: абстракции
клякс: скатилось
пят: клякс
пот: пятен
ков: пот
размаза: ков
холст: размазанных
люб: холсту
поверхн: любой
стоимост: поверхности
миллион: стоимостью
доллар: миллионы
зачаст: долларов
совершен: зачастую
непонятн: совершенно
х: шедевра
летн: х
ребенок: летний
мастит: ребенок
художник: маститый
нейросет: художник коту
кот: нейросеть генерацию напомним докрутить
опрокинувш: кот
банк: опрокинувший
варен: банку
реш: варенья
довер: решил
вкус: нейросети
аналог: вкус
наз: аналогия
красот: назов
аллегор: красоты
неточн: аллегорией
стохастическ: неточна
человек: мамонты конкретных
конкретн: похожие
личн: человеков
приветств: лично
лирическ: приветствую
отступлен: лирические
ближ: отступления
бер: ближе
учебн: бер
парочк: схему
бесхитростн: парочке
прос: бесхитростно
скрипт: сгенерировать генерит
случайн: скрипт
задан: схеме
общ: заданием
хочет: общем
поэт: большего
стран: поэтому
оставля: странно
пок: оставляет
генер: покое
характерн: скрипты
конструкц: характерные
вер: конструкции
проб: верит
декартов: пробует
произведен: декартово
фамил: реальные
воспользова: фамилии
помест: фейкерах
ссыла: предыдущий
пересказывает: ссылается
клиент: пересказываеть
пробова: клиент
недостатк: многие
поддержива: простить сотрудники
страниц: поддерживает
вигнешавара: страницу
читател: сетует
присутствова: читатели
триумф: присутствовали
толп: триумфе
народ: толпа
попа: народу
отбра: попал
заявлен: отбранных
восполня: заявленных
пересказыв: восполняет
знакомств: первого
полезн: знакомства
удачн: полезная
организова: удачно
наглядн: организована
кратк: наглядна вполне
вполн: краткое
содержан: краткая
вступлен: содержание
архитектур: применения
публикац: архитектура
подписк: публикации падения
процесс: подписки
инкрементальн: процессы
обработк: инкрементальная
паден: обработка
слот: подписке
фильтр: слот преимущества
строк: фильтры
преимуществ: столбцов
списк: фильтров
чита: списков
называ: известно
филип: называется
рст: филип
элизабет: рст
кристенс: элизабет
врут: кристенсен
интр: врут
сам: интро
шаг: первые
изучен: шаги
упомина: изучении
неожида: упоминаются
конетекст: неожиданном
оказывает: конетексте
создан: оказываетя
рассматрива: создании
вариант: рассматривали
сотрудник: варианта
изюминк: поддерживавшие
обо: изюминки
й: выбрали
подписа: блоге
тро: подписались
закир: артур
ихор: закиров
сирошта: ихорь
глав: шербаум
департамент: глава
поднят: баз
тревог: подняты
диск: тревоге
забит: диска
расч: забито
оста: расч
пришл: осталось
отлож: пришлось
субботн: отложить
разбира: дела
млн: нагенерила
коротк: файлов
поучительн: короткая
детективн: поучительная
истор: детективная
спойлер: история
некорректн: спойлер
запуст: некорректно
подробн: запустили
любительск: подробности
хобб: любительский
кокетств: хобби
адрес: блога
кристоф: адресом
петтус: кристоф
гендир: петтус
шут: гендир
погугл: шутит
настро: погуглите
скор: настроить
найд: скорее
возьм: роде
числ: возьмите
соединен: число
добавьт: соединений
цифр: поделите
соответствющ: цифру
ваш: соответствющую
знак: вашему
зодиак: знаку
водол: зодиака
конвертир: водолей
сист: конвертируйте
счислен: систему
основан: счисления сентября
готов: основанию коте
прочита: готово
обычн: прочитайте
десятичн: обычное
памя: нужная
мегабайт: память
спас: мегабайтах
формул: спасу лгут установить
лгут: формулы
лж: формула
чудовищн: лж
вр: чудовищно
приближен: первое
предлага: приближение
итерац: предлагает
установ: итерации
скаж: формул
свободн: скажем
системн: свободной
буфер: системные
устраива: буферы
остав: устраивает
заглянут: оставить
лог: заглянуть
найт: логи
времен: сообщения вдвое
см: временных
добав: см
вдво: добавить
жизн: случаи
отслежива: пользуйтесь
подобн: отслеживать
домашн: советует
вдохновител: домашние предыдущими
титус: вдохновители
котон: титус
де: котон
тулеар: де
хозяин: тулеар
полугодов: хозяина
перерыв: полугодового
очаровательн: перерыва
п: очаровательный
принадлеж: п
джозеф: принадлежит коллекции
скьяррин: джозефу
шьяррин: скьяррино
коллекц: шьяррино
построен: сооснователь
лиценз: базе
уличн: лицензия
скрипач: уличного
игра: скрипача
симфоническ: играл
оркестр: симфонических
мадагаскарск: оркестрах
бишон: мадагаскарский
холл: вдохновителями
куриц: холли
эмб: курица
котик: эмба
напомн: котик
лев: кота
кокот: лев
ак: кокотов
машин: ака
обучен: машинного
пулер: обучения
шардинг: пулер
блансировк: шардингом
нагрузк: блансировкой балансирует
аварийн: нагрузки
переключен: аварийным
мостаф: создатель
абдельрауф: мостафа
зайн: абдельрауф
кабан: зайн
теннер: кабани
горизонтальн: теннер
масштабирова: горизонтально
добавлен: простое
реплик: добавление
шардирован: реплик
реша: шардирование
добавля: новых
привязыва: хотелось
пользова: решением
недостаточн: пользовались
гибк: недостаточно
балансир: гибко
плюс: табличка
минус: плюсами
внешн: минусами
средств: внешними
побед: средствами
объясня: победил
докрут: объясняют
тег: готовимся
хаб: базы
голос: хабы
закладк: голосов
комментар: закладки
вконтакт: комментарии
карм: вконтакте
пользовател: карма
сутк: лучшие
сентябр: регистрации
январ: основания
числен: января
местоположен: численность
росс: местоположение
представител: россия
панченк: представитель
аккаунт: панченко
войт: аккаунт
новост: разделы
песочниц: авторы
устройств: песочница
документ: компаний
соглашен: документы
конфиденциальн: соглашение
услуг: конфиденциальность
корпоративн: услуги
медийн: корпоративный
нативн: реклама
проект: нативные
образовательн: проекты
стартап: программы
мегапроект: стартапам
дзен: мегапроекты
настройк: дзен
техническ: настройка
поддержк: техническая
стар: вернуться
postgr: postgres
profession: professional
pro: pro
igor: igor
le: le
postgresso: postgresso
postgresql: postgresql
pgconf: pgconf
russia: russia
axenix: axenix
softpoint: softpoint
evapp: evapps
debezium: debezium
oracl: oracle
christoph: christopher build
traver: travers
wors: worse
work: working replication setting
product: production
databas: databases
drunk: drunk
tire: tired
crazi: crazy
index: indexes
redi: redis
make: making
choic: choice
join: joins write
upd: upd
vigneshwaran: vigneshwaran
c: c
fujitsu: fujitsu
uuid: uuid
multimast: multimaster
geqo: geqo
potstgresql: potstgresql
pgdai: pgday
belgium: belgium
de: de
swiss: swiss
chri: chris
person: person
week: week
mysql: mysql
hbase: hbase
mongodb: mongodb
couchdb: couchdb
sqlite: sqlite
firebird: firebird
neo: neo
j: j
tb: tb
fosdem: fosdem
adjust: adjust
timescal: timescale
sql: sql
linkedin: linkedin
facebook: facebook
youtub: youtube
invok: invoking
perl: perl
pl: pl
enterpris: enterprise
posstgresql: posstgresql
cve: cve
client: client
memori: memory
disclosur: disclosure
connect: connecting
kerbero: kerberos
modifi: modified
server: server
org: org
gssapi: gssapi
libpq: libpq
enabl: enable
larg: large
mem: mem
buffer: buffers
bytea: bytea
text: text
pgsql: pgsql
union: union
aqo: aqo
pg: pg
probackup: probackup
ptrack: ptrack
pgpro: pgpro
schedul: scheduler
stat: stats
pwr: pwr
pgbouncer: pgbouncer
plv: plv
faker: faker
anonym: anonymizer anonymize
rapha: rapha
l: l
huchet: huchet
aka: aka
rap: rap
hpoutr: hpoutre
null: null
psql: psql
pganonym: pganonymize
public: public
pgantom: pgantomizer
julien: julien
rouhaud: rouhaud
python: python
librari: library
dalibo: dalibo
ai: ai
creat: creating
gener: a
app: generator
chatgpt: app
tooljet: chatgpt
teja: tooljet
kummarikuntla: teja
elephantsql: kummarikuntla
servic: elephantsql
gpt: service
turbo: gpt
rest: turbo
api: rest
d: api
write: d
queri: join
helena: queries
alexand: helena
dbforg: alexander
dml: dbforge
ddl: dml
left: ddl
cross: left
full: cross
outer: full
rauf: outer
chebri: rauf
neon: chebri
pgvector: neon
prabin: pgvector
acharya: prabin
pra: acharya
build: pra job
power: building
chatbot: powered
vercel: chatbot
openai: vercel
edg: openai
function: edge
davinci: functions
tiktoken: davinci
extens: tiktoken
fast: extension
bpe: fast
token: bpe
byte: tokenization
pair: byte
encod: pair
pagila: encoding
sakila: pagila
seri: sakila
md: series
random: md
java: random
js: java
rubi: js
malewicz: ruby
awesom: malewicz
db: awesome
tool: db
logic: tools
replic: logical
india: works
case: india
appli: cases
worker: apply
alter: worker
subscript: altering
synchron: subscription
commit: synchronous
tabl: commit
schema: tables
intern: schema
introduct: internals
backup: introduction base
philip: backups
hurst: philip
elizabeth: hurst
christensen: elizabeth
crunchi: christensen
data: crunchy
dump: data
restor: dump
base: restore rdbms
pgbackrest: backup
wal: pgbackrest
e: wal
g: e
bridg: g
tale: bridge
log: tale
artur: log
zakirov: artur
ihor: zakirov
siroshtan: ihor
andrea: siroshtan
scherbaum: andreas
nvme: scherbaum
set: nvme
wrong: work
s: wrong
job: s
pettu: christophe
expert: pettus
pgx: experts
pgbadger: pgx
titu: pgbadger
coton: titus
tulear: coton
pet: tulear
joseph: pets
sciarrino: joseph
wh: sciarrino
hydra: wh
milo: hydra
adopt: milo
pgcat: adopting
gen: pgcat
proxi: gen
levkk: proxy
pgml: levkk
failov: pgml
mostafa: failover
abdelraouf: mostafa
zain: abdelraouf
kabani: zain
andrew: kabani
tanner: andrew
instacart: tanner
makara: instacart
yandex: makara
odyssei: yandex
dbm: odyssey
rdbm: dbms
twitter: bases
livejourn: twitter
www: livejournal
postgrespro: www
ru: postgrespro
vk: ru
telegram: vk
habr: telegram
