хабр: хабр
откр: открыть
список: список
стат: стать статьи статье статей данная
автор: автором авторы вклад
поток: потоки обработки
разработк: разработка локальной
администрирован: администрирование
дизайн: дизайн
менеджмент: менеджмент
маркетинг: маркетинг
научпоп: научпоп
поиск: поиск интерфейса
профил: профиль
обнов: обновить
поддержк: поддержке техническая
рейтинг: рейтинг рейтинга
фреймворк: фреймворк
работ: работы лучших
контейнерн: контейнерными
приложен: приложениями логики развертывание другим распределенным подключений
компан: компании шэньчжэнь сайта
подряд: подряд
скопирова: скопировать
ссылк: ссылку документации
показыва: показывать
нов: новые новой машины относительно
лучш: лучшие авторов
порог: порог
уровен: уровень
сложност: сложности
прост: простой самых
средн: средний
сложн: сложный задача таких остается становится
примен: применить
час: часов
мир: мир первая
приключен: приключений приключения
сервер: серверу сервера сервер практике
част: часть
наблюден: наблюдение стеков
кэширован: кэширование
прочтен: прочтение
мин: мин
количеств: количество уменьшению
просмотр: просмотров
блог: блог
инфраструктур: инфраструктура вашу изменения
перевод: перевод организации
наш: нашей решали
предыдущ: предыдущей блокируется
рассмотрел: рассмотрели
интерфейс: интерфейс сетевые графического доступами
хранилищ: хранилища реализаций
исследова: исследовали
единствен: единственную единственная
реализац: реализацию реализация реализацией одна
дерев: дереве
внимательн: внимательное
сносок: сносок
пост: посте постов х
показа: показало
честн: честными
говор: говоря падения дела
оспор: оспорить
техническ: технической языка
треб: требуется
базов: базовая
подробн: подробно
рассмотр: рассмотрим
одн: одном инструмента
будущ: будущих
изуч: изучим
возможн: возможности возможно запуск
чита: читать подумал
дал: далее
голос: голосов
добав: добавить метрик
закладк: закладки
комментар: комментарии
новост: новости
апр: апр
добр: добро
пожалова: пожаловать
карьер: карьера
индустр: индустрии
состо: состоит
нескольк: нескольких
компонент: компонентов компонентами
значительн: значительная требований
взаимодейств: взаимодействий взаимодействуют
итогов: итогового
пользовател: пользователя пользователи ресурсов
систем: системой состоянием распределенная мониторинга улучшения
осуществля: осуществляется
помощ: помощи логи
представля: представляет
отправн: отправную
точк: точку пространства
мног: многих инженер
функц: функций контейнеров
проект: проект переводят
созда: создал д попробовал разворачиваем
существован: существования
расшир: расширен
поддержан: поддержания
дополнительн: дополнительной
произвольн: произвольной
функциональн: функциональности
поэт: поэтому
оказыва: оказывается
ограничен: ограниченным хостов изоляция
мест: местом
котор: которое названием
изначальн: изначально
задума: задумано
размещен: размещения
крайн: крайней
мер: мере
хорош: хорошего
сер: серии
погруз: погрузимся
дета: детали
получ: получим рекомендаций
представлен: представление
работа: работают работает
как: какими какие наличия
параллельн: параллельно
поэкспериментиру: поэкспериментируем
замен: заменой
пользовательск: пользовательских пользовательскими
создад: создадим
инструментар: инструментарий
модифицирова: модифицировали
соответств: соответствии
кейс: кейсами микросервисы
знает: знает
постро: построим
собствен: собственный
разрез: разрезе
умеет: умеет
сам: самый установить
популярн: популярный развитие
обзор: обзор
виде: видео
доклад: доклада докладе доклад
конференц: конференции
олег: олега
бунин: бунина
онтик: онтико
флант: флант
системн: системное
препарир: препарирую
даб: дабы
поня: понять
подводн: подводные
камн: камни
правильн: правильно
пользова: пользоваться
сдела: сделал сложная
ждат: ждать
внедрен: внедрения
рекоменд: рекомендую
ознаком: ознакомиться
прощ: ним
управля: проще научились удалении
распределен: управляем представьте пойдет словами внутри
транзакц: распределенными детерминированно распределенных
сервис: транзакциями облачные отдельных рассматривается насыщенности
саг: сервисах
виртуализац: саг появилась
облачн: виртуализация
микросервис: сервисы включающая
привет: кейс
зовут: привет
ил: зовут
казначе: илья
техлид: казначеев
команд: техлид
представьт: команде
процесс: распределенный рабочего
сотн: процесс
шаг: сотни последовательно
выполня: шагов
последовательн: выполняется
подразумева: шаг
вызов: подразумевает
отдельн: вызовов
управлен: сервисов уведомления отслеживания
состоян: управление изменение заданное нужному
задач: системе такую поставленной различных
изменен: сделать правды
происход: состояния
детерминирова: происходило
либ: транзакция
выполн: либо
заверш: выполнилась
полност: завершился
откат: полностью
произошл: откатился
ошибк: произошла
главн: ошибка
пошел: главное
перезапуст: пошел
так: перезапустился примеру ресурсам
реша: задачу
расскаж: наших
науч: расскажу
включа: управлять любая
дюжин: включающими
сраз: дюжину
скаж: сразу
реч: скажу
пойдет: речь
баз: транзакциях инстанс наблюдения
дан: баз приветствую
уровн: данных
бизнес: уровня
логик: бизнес
истор: приложения
сред: истории производственных
настройк: среде запуска
туториа: настройка
приветств: туториал
рассматрива: статья неполадок
необходим: рассматривает логов связанные
достаточн: необходимые подключиться
действ: достаточные
запуск: действия быстрый
кластер: настройки реплицированный связь доступа получать
прецедент: кластере
апрел: прецедентов
вне: апрель
найд: вне
пришл: найдено
провест: пришлось
тысяч: провести
эксперимент: тысячи
отброс: экспериментов
приня: отбросить
множеств: принять обладает
гипотез: множество
перв: гипотез означает
выкатк: мире
быстр: выкатка подходит удобно
установ: возможность
конфигурац: простых
установк: конфигураций
оптимизирова: установка
производствен: оптимизирована
идеальн: сред
подход: идеально внимание общем
локальн: быстрой
реализ: разработки
программн: реализующий обработку
шин: программную
использ: шину реального метрики
потоков: использующую
обработк: потоковую задержкой
платформ: программная унифицированной
открыт: платформа
исходн: открытым качестве
код: исходным
разработа: кодом
написа: разработанная
направл: написанная
предоставлен: направлен
унифицирова: предоставление
высок: платформы низкого
пропускн: высокой
способн: пропускной
мал: способностью
задержк: малой замеры
реальн: потоков режиме
ин: реальном
слов: иными
обм: система
сообщен: обмена
серверн: сообщениями микросервисных
режим: серверными
ран: использует
верс: ранней старую
назван: версии юаней содержании
устран: котором
зависим: устранена
реплицирова: зависимость реплицированная развернем
групп: реплицированные
ов: группы
аналогичн: ов
ам: аналогичные
реплик: ам подов количества
получа: реплика сможет
постоя: получает усугубляется
хост: постоянное имен
уникальн: хоста
индекс: уникальным высокого
например: индексом
д: например
порядк: создается ограничений
низк: порядке
создан: индекса
блокир: создание
станет: предыдущим
работоспособн: станет
доступн: работоспособным
относ: доступным
масштабирован: относится отказа
удален: масштабированию
под: управляемых базы изолировать другими
удаля: реплики
убыван: удаляется
уменьшен: убывания
набор: реплик
требован: набор
упроща: значительно
развертыван: упрощает распространение
хранен: приложений
сочетан: хранения пул
стабильн: сочетание
им: стабильных
означа: порядка
надежн: первой запустить
ссыла: надежно
цел: ссылаться
обнаружен: целей
установлен: обнаружения
кворум: установления
репликац: кворума
разверн: репликации давайте
подключа: кластер
настраива: подключаем быстро
уведомлен: настраиваем мониторинг
удобн: управлением технологиях предоставляющий реализованы
мониторинг: настраивать столпов
воспользу: уведомлениями
метрик: воспользуемся факт
дашборд: добавим
алерт: дашборд
настро: алерт
оповещен: настроим
перевезт: оповещение
ваш: перевезти
лета: инфраструктуру
облак: летать
дни: облаках
современ: дни основанная
имеет: современный
взлет: имеет
паден: взлеты
разрабатыва: говорим
сво: разрабатывающей микросервисов
продукт: свой популярных
мож: продукт
свидетел: можем
рожден: свидетелями
участник: рождения
бывш: участниками
офицер: бывший
шэньчжэн: офицер
капитал: компанию
юан: капиталом
инженер: название любого
задумыва: многие
смыслов: задумываются
содержан: смысловом
кита: названия
достижен: китай кэшей
стоп: достижение
мыслен: стоп
подума: мысленно
хоч: читаю
узна: хочу файловой
обсто: узнать
дел: обстоят
сут: говорить
предоставля: сути сервис сущности
рынк: предоставляется
хотел: рынке
впада: хотелось
полемик: впадать
никак: полемику
инач: никак
обсуд: иначе
ряд: обсудим
вопрос: ряд подойти возникают
интерес: вопросов
люб: интересуют взаимодействовать нные
реш: инженера стороны
связа: решившего безопасности
проектн: связать
деятельн: проектную
пониман: деятельность
рабоч: понимания
чарт: процесса способах
замеча: чартов
пут: замечаешь
доб: путей
поставлен: добиться
вариант: задачи
решен: вариантов приведем именем
новичк: решений
трудн: новичку
попробова: трудно
общ: создать приводят объединяются
указан: общих
рекомендац: указаний
оптимальн: получить
способ: оптимальных
х: чартами
основн: постах
документац: основном
широк: ссылке
распространен: широкое
использован: развертывания
стал: использованием
причин: стало истинную
написан: причиной
попробу: написания
подойт: попробуем
практическ: вопросу
сторон: практической
налич: решить
специфичн: каких
знан: специфичных
област: знаний
качеств: области
возьм: исходных
след: возьмем
мар: следующее
собира: мар
лог: собирать виды
логирован: помощью
трех: логирование
столп: трех
видет: системах
бурн: видеть
развит: бурное масштабирования виток
тип: продуктов
полноцен: типа
коммерческ: полноценных
помога: коммерческих
проблем: помогают сложной обнаружить
протоколирован: проблемами сложных
больш: протоколирования вс вызывает
масштаб: больших
пример: масштабах
оста: протоколирование
усугубля: проблемой
рост: постоянным
объем: ростом
вс: объема
контейнеризац: большего
различн: контейнеризации выполнения
вид: различные
улучшен: необходимых
удел: системы
вниман: уделим
сбор: подходам упростит
агрегац: сбору
анализ: агрегации
привед: анализу
упрост: решение
эфемерн: сбор добавлена
контейнер: эфемерные эфемерных
предислов: контейнеры
добавл: предисловие
позволя: функция
запуска: позволяет ах
времен: запускать оркестрации
рамк: временные
существ: рамках задач заменяют решения
помоч: существующих
диагностик: помочь
отладк: диагностике
пробл: отладке
выполнен: проблем
окружен: существующего
заменя: окружения
ах: существующие
сетев: запускаются файловая существует модели определяется
пространств: сетевого изоляции
монтирован: точками
легк: монтирования
доступ: легко безопасного правами
ресурс: доступ развернутых
файлов: таким сетевой
разворачива: интерфейсы
виртуальн: создаем запустим
машин: виртуальные виртуальную
релиз: новом
появ: релизе
основа: виртуализации
технолог: современных
привычн: удобном
жизнен: привычном
цикл: жизненным
практик: циклом
запуст: сервере узнаем
протестиру: машину
обеспечива: протестируем
связ: обеспечивается
маг: кластера
организац: магии временем
безопасн: организация информационная вопросы
информацион: кластеров
явля: безопасность
сист: является
оркестрац: систем
рельс: проекты
возника: рельсы
контрол: необходимостью
сможет: контроля
умолчан: кластеру
подключ: умолчанию
стандартн: достаточно
конфигурацион: стандартного
файл: конфигурационного
имен: файла
одноэлементн: надежный
инстанс: одноэлементный
предостав: пода
друг: предоставить любыми потестируем друг
политик: приложениям сетевыми
изоляц: политики адресов
н: пространств
изолирова: н
помогут: поды
модел: помогут сетевая
определя: модель ограничение
адрес: определяет подами
взаимодействова: адрес
дава: политиками
потестиру: разверн
графическ: другом
неполадок: поиска
веб: удобный
реализова: веб
инструмент: удобные сочетания закрыть
отслеживан: инструменты инструментов
развернут: управления
случа: пользователей
непредвиден: случае
ситуац: непредвиденных
микросервисн: ситуаций
распредел: серверное
нны: распредел
источник: своими хранилищем идентичному
запущен: источниками
внутр: запущенная
облада: приложением
точек: множеством
отказ: точек производительности
станов: развития
обнаруж: сложнее
функционирован: проблемы
долг: функционировании
ответ: долгий задержки
привод: ответ
потер: общей
производительн: потере
нагрузк: отказам
неудачн: нагрузке отклонения
стечен: неудачных
обстоятельств: стечениях
факт: обстоятельств
замер: используются
интенсивн: ответа
запрос: интенсивности
операцион: запросов
насыщен: операционные
отношен: сервиса
одновремен: отношение
обрабатыва: одновременно
лимит: обрабатываемых достижения
процессорн: лимиту
зарезервирова: процессорного
памят: зарезервированной
выясн: памяти
истин: выяснить
возникновен: причину
отклонен: возникновения
кэш: неудачная
подключен: лимита
пул: приложение
операц: отслеживание
объединя: операций
стек: подходе
мнен: базе
относительн: мнение
виток: новый
депло: развитии
посмотр: деплоя
закр: посмотрим
правд: источник
проход: инфраструктуре
провод: проходят
специальн: проводит
агент: специальный
поддержива: агент
зада: поддерживает
внест: состояние
вручн: внести
увид: вручную
несоответств: увидит
верн: несоответствие
нужн: верн
идентичн: состоянию
живет: источнику
развертыва: живет
сущност: развертывает
прав: предоставляет
посмотрет: интерфейсе
принудительн: посмотреть
синхронизирова: принудительно
вход: синхронизировать
вызыва: входит
довер: большое
сюд: доверие
вклад: сюда
ваканс: работа
аккаунт: вакансии
войт: аккаунт
регистрац: войти
раздел: регистрация
хаб: разделы
песочниц: хабы
информац: песочница
устройств: информация
сайт: устройство
документ: компаний
соглашен: документы
конфиденциальн: соглашение
услуг: конфиденциальность
корпоративн: услуги
медийн: корпоративный
реклам: медийная
нативн: реклама
образовательн: нативные
программ: образовательные
стартап: программы
спецпроект: стартапам
яндекс: спецпроекты
дзен: яндекс
язык: дзен
вернут: поддержка
стар: вернуться
kubernet: kubernetes
rss: rss
anna: anna
sokol: sokol
api: api
southbridg: southbridge
devop: devops
etcd: etcd
cacher: cacher
s: s
asa: asa
driusha: driusha
istio: istio
servic: service
mesh: mesh
kuber: kuber
conf: conf
cloudmt: cloudmts
containerum: containerum
itoracl: itoracle
oracl: oracle
real: real
applic: application
cluster: clusters cluster
bare: bare
metal: metal
linux: linux
rac: rac
cloud: cloud
docker: docker
maxrokatanski: maxrokatansky
kafka: kafka
kraft: kraft
otu: otus
apach: apache
softwar: software
foundat: foundation
scala: scala
java: java
raft: raft
zookeep: zookeeper
volum: volumes
mongodb: mongodb
statefulset: statefulset
pod: pod
replicaset: replicaset
databas: database
zimmermann: zimmermann
victoriametr: victoriametrics
deckhous: deckhouse
telegram: telegram
grafana: grafana
gacblk: gacblk
sbercloud: sbercloud
nixi: nixys
hua: hua
wei: wei
huawei: huawei
rotorocloud: rotorocloud
helm: helm
practic: practices
part: part
http: https
sh: sh
doc: docs
chart: chart
al: ale
da: da
rail: rails
rubi: ruby
sovasova: sovasova
fluentd: fluentd
fluent: fluent
bit: bit
elk: elk
stack: stack
splunk: splunk
open: open
sourc: source
artazar: artazar
timeweb: timeweb
ephemer: ephemeral
contain: containers
zhbert: zhbert
kubevirt: kubevirt
cilium: cilium
linstor: linstor
shaman: shaman
teleport: teleport
firstvd: firstvds
config: config
mysql: mysql
nf: nfs
ip: ip
nat: nat
ageshock: ageshocker
komodor: komodor
dmitriizolotov: dmitriizolotov
observ: observability
sermalenk: sermalenk
gitop: gitops
argo: argo
cd: cd
kt: kts
pull: pull
git: git
rbac: rbac
cncf: cncf
shurup: shurup
distol: distol
wimbo: wimbo
wellsbart: wellsbart
askobin: askobin
aigrychev: aigrychev
polina: polina
averina: averina
kvap: kvaps
zuzza: zuzzas
facebook: facebook
twitter: twitter
vk: vk
youtub: youtube
habr: habr
