хабр: хабр хабра
откр: открыть открыт
список: список
стат: стать статьи статье статей
автор: автором авторы вклад
поток: потоки
разработк: разработка разработкой
администрирован: администрирование
дизайн: дизайн
менеджмент: менеджмент
маркетинг: маркетинг
научпоп: научпоп
поиск: поиск
профил: профиль
обнов: обновить
рейтинг: рейтинг рейтинга
криптовалют: криптовалюты криптовалюта криптовалюту криптовалюте криптовалют
деньг: деньги
компан: компании компанией компания сайта
подряд: подряд
скопирова: скопировать
ссылк: ссылку ссылками
показыва: показывать
нов: новые новых новый
лучш: лучшие авторов
порог: порог
уровен: уровень
сложност: сложности сложностями
прост: простой простое
средн: средний средней среднюю
сложн: сложный
примен: применить
час: час часов часа
проблематик: проблематика
текущ: текущей
концепц: концепции
миров: мировой
сетев: сетевой
инфраструктур: инфраструктуры
решен: решение
помощ: помощи помощью
децентрализова: децентрализованного децентрализованных децентрализованные децентрализованная
детерминизм: детерминизма
прочтен: прочтение прочтения
мин: мин
количеств: количество
просмотр: просмотров
читальн: читальный
зал: зал
истор: история историю истории
репортаж: репортаж
привет: привет
уважа: уважаемые
хабровц: хабровцы
пиш: пишу
наболевш: наболевшем
понима: понимаю понимают
информац: информация информации информацию
разрознен: разрозненной
постара: постарался
рассказа: рассказать
основн: основную основным основной
понят: понятиям
част: часть частью
понятн: понятна
мастодонт: мастодонтам
област: области
ознакомительн: ознакомительна
дума: думаю
интересн: интересна интересные
мног: многим многие
над: надеюсь
весьм: весьма
откладыва: откладывать
вопрос: вопрос ответы
долг: долгий
ящик: ящик
приступ: приступим
приступа: приступать
голос: голосов
добав: добавить
закладк: закладки
комментар: комментарии
новост: новости
ликвидн: ликвидный ликвидного ликвидность ликвидном ликвидности
стейкинг: стейкинг стейкинга стейкинге
технолог: технологии технология
увелич: увеличит увеличить увеличилось
капитализац: капитализацию капитализации падала
раз: разы
финанс: финансы финансов
обзор: обзор обзора
преддвер: преддверии
обновлен: обновления
изуч: изучили
ончейн: ончейн
показател: показатели показателем
проект: проектов проектам проект проекта проекты
развива: развивающих
экосист: экосистему
собра: собрали собрать
план: планах
развит: развития развита развитие
разобра: разобрали разобрать
описа: описали
позволя: позволяют позволяет
сильн: сильно сильной сильных сильные
масштабирова: масштабировать
эфириум: эфириум эфириума
перспектив: перспективе перспективы
подготов: подготовили подготовила
сер: серию
будущ: будущем будущего
перв: первая первых
дериватив: деривативов
материал: материале
разбер: разберем
заключа: заключается
счита: считается считают
прорыв: прорывом
блокчейн: блокчейн блокчейне блокчейна
пространств: пространства
заработа: заработать заработали
тренд: тренде тренд трендов тренда
порассужда: порассуждаем
явля: является являются
явн: явным
нарратив: нарративом
крипт: крипте крипты крипту крипта крипто
поеха: поехали
содержан: содержание
обернут: обернутые
ток: токены токена события
провайдер: провайдеры
полож: положить
эфир: эфир
преимуществ: преимущества
увеличива: увеличивает
монет: монет монеты
риск: риски рисках риском
централизац: централизация
регуляц: регуляция регуляции
вывод: выводы
чита: читать
дал: далее дал
апр: апр
илон: илон
маск: маск маска
памп: пампит
продава: продавать
манипуляц: манипуляции
крипторынк: крипторынком грозить заражения
привел: привели
криптограф: криптография
медийн: медийная
реклам: реклама
вчер: вчера
вечер: вечером
апрел: апреля
выросл: выросла
момент: моменте момент моменты момента
написан: написания
торг: торгуется торгов
сутк: сутки
пол: пол
обогна: обогнав
вышл: вышла
мест: место
логичн: логично
произошл: произошло криптовалютным
вследств: вследствие
смен: сменил
логотип: логотип
известн: известной
птичк: птичкой
собачк: собачку
мем: мем
символ: символ
подобн: подобные
шаг: шаги
влия: влияют
крипторынок: крипторынок
расскаж: расскажем
негласн: негласным
амбассадор: амбассадором
подробн: подробно подробности
останов: остановимся
вид: видим вид
обяза: обязаны
знат: знать
личн: лично
мо: моем моего
окружен: окружении
сам: самый самые самым обвал
далек: далекий
позвон: позвонил
поинтересова: поинтересовался
сто: стоит
покупа: покупать
дела: делать
правильн: правильно
хочет: хочет
кибернетическ: кибернетического
апокалипсис: апокалипсиса
мусульман: мусульманам
запрет: запретили
трейд: трейдить
плеч: плечом
дайджест: дайджест
финансов: финансовые финансовой пятницу размер
росс: россии
мир: мире
недел: неделю недель
тинькофф: тинькофф
модн: модным
технологичн: технологичным
банк: банком банки банков главный
очередн: очередной
пуга: пугает
россия: россиян
номинант: номинантом
прем: премии
дарвин: дарвина
оказа: оказался
парен: парень
эмират: эмиратов
сэм: сэма
банкма: банкмана
фрид: фрида
появ: появились
уголовн: уголовные
мар: мар
зарабатыва: зарабатывать
активн: активностях активных активно
сет: сетях сети сетью
ретродроп: ретродропы
тестнет: тестнеты тестнетах
тестирован: тестирование
веб: веб
сервис: сервисов
подел: поделились поделимся поделиться
опыт: опытом
получен: полученным получение получением
наш: нашего узнаете
участ: участия
дроп: дропах дропа
поучаствова: поучаствовать
выгодн: выгодно
раздава: раздавать
ран: ранним
пользовател: пользователям пользователю
контекст: контексте
коснул: коснулись
углуб: углубились
тонкост: тонкости
как: каким какую какие какими
образ: образом
сво: свой
шанс: шанс шансы
хорош: хорошего хороших
материа: материал
вышел: вышел
немаленьк: немаленький
поэт: поэтому
якорн: якорными
приятн: приятного
больш: большой большими
рекордн: рекордно рекордной рекордная рекордный
высок: высокая высоким
инфляц: инфляция инфляцией инфляции
кризис: кризис кризиса
полон: полон
негативн: негативных
политическ: политических политической
экономическ: экономических экономической
событ: событий тревожные
стран: странам странах стран
экономик: экономикой экономиках
пришл: пришлось
прибегнут: прибегнуть
крайн: крайним
мер: мерам
справ: справиться
введен: введение
вопрек: вопреки
ожидан: ожиданиям
криптовалютн: криптовалютный криптовалютном криптовалютных марта заскамит
рынок: рынок
тих: тихой
гаван: гаванью
разраз: разразившегося разразившаяся
криптоэнтузиаст: криптоэнтузиасты
надея: надеялись
растущ: растущая растущие
повлия: повлияет разбираемся
некотор: некоторые некоторых
наоборот: наоборот
предрека: предрекали
бурн: бурный
рост: рост роста
период: период
ясн: ясно
поня: понять
коррелир: коррелируют
фондов: фондовым
рынк: рынком рынков рынке рынками финансовых капитализация криптовалютному
макроэкономическ: макроэкономические
фактор: факторы
точн: точно
ситуац: ситуациях ситуацией стейблкоинами
реакц: реакция
существен: существенной
важн: важно важной важным
след: следить
глобальн: глобальными
определя: определяющими
направлен: направления направленное
бушева: бушевал
медвеж: медвежий медвежьего
причин: причиной
послуж: послужила
войн: война войну
украин: украине
энергетическ: энергетический
спровоцирова: спровоцировали
практическ: практически
оценива: оценивались
трехзначн: трехзначными
цифр: цифрами цифры
цен: цены цене снижением
застав: заставили
центральн: центральные
перейт: перейти
сдерживан: сдерживанию
повыш: повышая
процентн: процентные
ставк: ставки
тенденц: тенденция тенденций
сохраня: сохраняться
пятерк: пятерку
уровн: уровнем
вход: входят
зимбабв: зимбабве
лива: ливан
венесуэл: венесуэла
сир: сирия
суда: судан
владеет: владеет
биткоин: биткоинами биткоином
исследован: исследование исследовании исследования
перевод: перевод
команд: команда команду
выясн: выяснить
так: таки
польз: пользуется
развея: развеять
миф: миф
спекулятивн: спекулятивный
инструмент: инструмент
сег: сего
средств: средство
помога: помогающее
преступник: преступникам
соверша: совершать
мошенническ: мошеннические
схем: схемы
встреча: встречал
люд: людей
каза: казалось
сторон: стороны
высокотехнологичн: высокотехнологичных
хаб: хабах разделы
сомнева: сомневаются
получ: получит получил
широк: широкий
масс: масс
адопш: адопшен
дан: данном
люб: любит
сообществ: сообщество
факт: факты
допущен: допущения допущении
расчет: расчет
ошибок: ошибок
возможн: возможных
смел: смелые
гипотез: гипотезы
подтвержден: подтверждение
опровержен: опровержение
отличн: отличный отличные
ближайш: ближайшем ближайшую
перспективн: перспективная
валют: валюта валюты
успешн: успешно
отб: отбилась
атак: атаки атак
готов: готовится готовят
отыгра: отыграть
позиц: позиции
желан: желание
пар: пару
быстр: быстрые
минимальн: минимальным
присмотрет: присмотреться
десятк: десятка
откуд: откуда
уверен: уверенность уверенно
анализ: анализ
скользя: скользящей скользящую
дне: дней
популярн: популярный популярности
индикатор: индикатор
определен: определения
общ: общих общее
наход: находится
выш: выше
дневн: дневной дневную
месяц: месяц
превыс: превысила
повторн: повторно
тестир: тестирует
никак: никаких
признак: признаков
главн: главных крах самое
киберугроз: киберугрозах киберугрозы
массов: массовые
утечк: утечки
взлет: взлет
вайпер: вайперов
межотраслев: межотраслевые межотраслевых
последств: последствия последствий
блог: блог
информацион: информационная
безопасн: безопасность
прогноз: прогнозы
аналитик: аналитика аналитики
специалист: специалисты
проанализирова: проанализировали
актуальн: актуальные
инцидент: инцидентов
сравнен: сравнению
год: годом
одн: одними одну одни
стал: стали банкротство
увеличен: увеличение
числ: числа
связа: связанных доллару
ресурс: ресурсами
появлен: появление
усилен: усиление
кат: катом кат
сша: сша
объяв: объявили
крупн: крупнейшей связан токен
криптобирж: криптобирже криптобиржи криптобиржа криптобирж
регулирован: регулирование регулированию
американск: американски вторым заражение
понедельник: понедельник
обвин: обвинила
основател: основателя
чанпэн: чанпэна
чжа: чжао
нарушен: нарушении
закон: законов
поговор: поговорим
вообщ: вообще
американц: американцы
подход: подходят
криптан: криптанов
конкретн: конкретно
обвиня: обвиняют
бинанс: бинанс
гроз: грозит сегодняшнем
сезон: сезон
охот: охоты
проблем: проблемы
европейск: европейских
углубля: углубляются
рф: рф
хот: хотят
ввест: ввести
иис: иис
предъяв: предъявили
претенз: претензии
немецк: немецкий
шата: шатается
квон: квона
лунокоин: лунокоина
арестова: арестовали
черногор: черногории
жестк: жесткие
обвинен: обвинения
сдела: сделать
авторизац: авторизацию авторизация
кошельк: кошелька
туториа: туториал туториала
приложен: приложений приложения
туториал: туториале
пошагов: пошагово
собер: соберем
задач: задача
одностраничн: одностраничное
сайт: сайт устройство
кнопк: кнопкой
реализ: реализующей
простот: простоты
вещ: вещи
улучш: улучшить
точк: точки
зрен: зрения
оптимизац: оптимизации
код: кода
опущ: опущены
останавлива: останавливаться
стил: стилях
цел: цель целью
удобн: удобный удобного
расширен: расширения
нужд: нужды
пример: пример
разбор: разбор
нашумевш: нашумевшего
криптопроект: криптопроекта
токен: токене токеном
разговор: разговоры
утиха: утихают
вряд: вряд
утихнут: утихнут
конц: конца
ожида: ожидаемый главное
эйрдроп: эйрдроп
проанализиру: проанализируем
токеномик: токеномику токеномика
инвестор: инвесторов
заглян: заглянем
капот: капот
определ: определив
технологическ: технологическую
ценност: ценность
созд: созда
кейс: кейсом кейс
ребят: ребята
планиру: планируем
ещ: ещ
объемн: объемный
ориентирован: ориентирования
создан: создания
фонд: фонды
инвестиц: инвестиции
техническ: техническая техническими
подвох: подвох
экосистем: экосистема экосистемы
работа: работают
запуск: запуск запуска
раздач: раздача
прошл: прошла прошлого
улетел: улетел
космос: космос
кит: киты
осторожн: осторожно
скам: скам
нача: начать
пользова: пользоваться
итог: итоги итоге
ликбез: ликбез
фундаментальн: фундаментальный
объединя: объединяет
бирж: биржи биржах биржа
централизова: централизованную централизованная централизованных централизованной
предоставлен: предоставления
трейдер: трейдерам трейдеров
глубок: глубокой
низк: низкой
созда: создана создан создается
занима: занимается занимаюсь
многостратегическ: многостратегической
высокочастотн: высокочастотной
торговл: торговлей торговлю
имеет: имеет
ежедневн: ежедневный
объ: объем объ
ведущ: ведущих
миллиард: миллиардов
доллар: долларов доллар привязку
основа: основана
групп: группой
выпускник: выпускников
университет: университета
карнег: карнеги
меллон: меллона
соверш: совершили
переход: переход
традицион: традиционных
маркет: маркет
мейкер: мейкером
настоя: настоящее
разнообразн: разнообразный
набор: набор
продукт: продуктов продуктом
спотов: спотовым спотовую
фьючерсн: фьючерсным
институциональн: институциональных
клиент: клиентов
платформ: платформа платформу
агрегир: агрегирует
торгов: торговых торговой
площадок: площадок
предлага: предлагает
нулев: нулевой
комисс: комиссией
полност: полностью
настраива: настраиваемый
модульн: модульный
интерфейс: интерфейс
своп: своп
поддержк: поддержкой языка
кроссчейн: кроссчейн
обм: обмена
криптоактив: криптоактивов
доходн: доходности
сч: сч
односторон: одностороннего
использован: использования
актив: активов активы
использ: использует
алгоритм: алгоритма
синтетическ: синтетического
проактивн: проактивного
мейкинг: мейкинга
задействован: задействования
курс: курсов курсам криптоиндустрии
площадк: площадки
торгова: торговать
мам: мами
рамк: рамках
одновремен: одновременно
сохран: сохраняя
полн: полное
прав: право
собствен: собственности
выраст: вырастил
аудитор: аудиторию
науч: научился
браузер: браузеров
интернет: интернет
стартап: стартапа программы
хоч: хочу
запуст: запустить
январ: январе
использова: использовал
процесс: процессе
работ: работы работая лучших
придума: придумал
ид: идею
упрост: упростить
реализова: реализовал
фулл: фулл
тайм: тайм
твиттер: твиттера
отзыв: отзывов
оп: опыт
небольш: небольшого
напиш: напишу
сталкива: сталкивался
продвига: продвигал
соцсет: соцсетях
достигнут: достигнутые
результат: результаты
добр: добро
пожалова: пожаловать
надежн: надежные
стейблкоин: стейблкоины стейблкоинов капиталлизации другими
пыта: пытаемся
найт: найти
устойчив: устойчивый
сред: среди
прошел: прошел
публикац: публикации
фигурант: фигурант
то: той
успел: успел
обнул: обнулиться
испыта: испытали
мощн: мощный
депег: депег
оста: оставшимся
регулятор: регуляторы
накида: накидали
куч: кучи
всяк: всяких
предъя: предъяв
впечатлен: впечатление
приличн: приличных
стейбл: стейблов
существ: существует
дава: давайте
вмест: вместе
разбира: разбираться коммерческих
срок: срок
майнинг: майнинг
скор: скорое
пришеств: пришествие
эпическ: эпическая
схватк: схватка
харальдур: харальдуром
навернул: навернулся
вкладчик: вкладчиков
спасут: спасут
лопнул: ним
байд: лопнул
повыс: байден
налог: повысить
собира: налоги
стро: собирается
маскоград: строить
крах: маскоград
техн: банк
стартапер: техно
кремниев: стартаперов
долин: кремниевой
пятниц: долины
произошел: рынках
громк: произошел
хлопок: громкий
внезапн: хлопок
й: внезапно
размер: й выживет
банкротств: размеру
втор: стало
коммерческ: американских
потеря: повлиять
привязк: потерял
угрожа: крупнейший
ноч: угрожает опасность
капиталлизац: ночью
сегодняшн: стейблкоин
прич: крипторынку
заражен: причем финансового
банковск: американской
систем: банковской
тем: системы
друг: тему
отраз: ситуация
криптоиндустр: отразиться выдержит
дел: курс
обеспечен: дела
паден: обеспечение
случ: падение
эффект: случилось
домин: эффект
зацеп: домино
выживет: зацепило
ночн: крипторынка
криптокр: ночной
опасн: криптокрах
март: ночь
тревожн: произошли
обвал: крупнейших
остальн: обвалился
отреагирова: остальные
снижен: отреагировали
пада: цена
уменьш: рынка
примерн: уменьшилась
составля: примерно
млрд: составляет
выдерж: млрд
удар: криптоиндустрия
станет: удар
последн: станет держать
вызва: последним
вчерашн: вызван
обва: вчерашний
идт: ожидать
толп: идти
держа: толпы
ответ: последнего
узна: вопросы
первопричин: нашем
происход: первопричина
джастин: происходит
сан: джастин
заскам: сан
сюд: рынку
вклад: сюда
разработчик: работа
ваканс: разработчик вакансий
аккаунт: вакансии
войт: аккаунт
регистрац: войти
раздел: регистрация
песочниц: хабы
устройств: песочница
документ: компаний
соглашен: документы
конфиденциальн: соглашение
услуг: конфиденциальность
корпоративн: услуги
нативн: корпоративный
образовательн: нативные
программ: образовательные
спецпроект: стартапам
яндекс: спецпроекты
дзен: яндекс
настройк: дзен
язык: настройка
вернут: поддержка
стар: вернуться
верс: старую
rss: rss
valerylinkov: valerylinkov
webassembl: webassembly
web: web
mediametriqa: mediametriqa
lsd: lsd
ethereum: ethereum
shanghai: shanghai
eth: eth
liquid: liquid
stake: staking
deriv: derivatives
weth: weth
steth: steth
yeth: yeth
dogecoin: dogecoin
btc: btc
doge: doge
cardano: cardano
twitter: twitter
rationalansw: rationalanswer
interact: interactive
broker: brokers
apto: aptos
arbitrum: arbitrum
spacefin: spacefinance
recoveri: recovery
mode: mode
coinshar: coinshares
global: global
bitcoin: bitcoin
ownership: ownership
overview: overview
artemiil: artemiil
hedera: hedera
hbar: hbar
ma: ma
parabol: parabolic
sar: sar
ptsecur: ptsecurity
posit: positive
technolog: technologies
binanc: binance
cftc: cftc
credit: credit
suiss: suisse
ub: ubs
deutsch: deutsche
bank: bank
terrausd: terrausd
tron: tron
coinbas: coinbase
ivanromanovich: ivanromanovich
ton: ton
tonconnect: tonconnect
sdk: sdk
tonkeep: tonkeeper
arb: arb
optimist: optimistic
rollup: rollup
woo: woo
network: network
krono: kronos
research: research
cefi: cefi
defi: defi
x: x
woofi: woofi
c: c
spmm: spmm
root: root
pet: pet
chrome: chrome
dune: dune
react: react
typescript: typescript
usdt: usdt
usdc: usdc
busd: busd
dai: dai
tusd: tusd
gpt: gpt
silicon: silicon
vallei: valley
signatur: signature
usd: usd
circl: circle
usdd: usdd
kucoin: kucoin
huobi: huobi
silverg: silvergate
sec: sec
alizar: alizar
mark: marks
d: d
halli: halli
wirex: wirex
polybiusbank: polybiusbank
sardarbinyan: sardarbinyan
id: id
cigulev: cigulev
blockchain: blockchain
facebook: facebook
vk: vk
telegram: telegram
youtub: youtube
habr: habr
