хабр: хабр хабре хабра хабру
откр: открыть
список: список
стат: стать статьи
автор: автором авторы авторов
поток: потоки
разработк: разработка разработки
администрирован: администрирование
дизайн: дизайн дизайном
менеджмент: менеджмент
маркетинг: маркетинг
научпоп: научпоп
поиск: поиск
профил: профиль
обнов: обновить
сам: самое
нов: новые новый новую
ожида: ожидают
приглашен: приглашения
интерес: интересуются
сторон: сторонами
современ: современной
жизн: жизни
программирован: программированием
технолог: технологиями
наук: наукой
образован: образованием
игр: играми
карьер: карьерой
здоров: здоровьем здорово
обязательн: обязательно
писа: писать
хардкорн: хардкорно
важн: важно
польз: польза пользу
крут: крутой
материа: материал материала
площадк: площадке
запост: запостите
сообществ: сообщество сообществу
оцен: оценило
пост: пост постом
полез: полезен
написа: написан написать написали
прочита: прочитают прочитает прочитали
десятк: десятки
появ: появится
вк: вк
фейсбук: фейсбуке
телеграм: телеграме
попадет: попадет
почтов: почтовую
рассылк: рассылку
лучш: лучшего
недел: неделю
вс: вс
произойдет: произойдет
пишет: пишете
проверя: проверяют
модератор: модераторы
отправля: отправляют
основн: основную
лент: ленту
набира: набирает
просмотр: просмотры просмотров
комментар: комментарии комментариях
рейтинг: рейтинг рейтингом
дальн: дальнейшем
премодерац: премодерация
понадоб: понадобится
попрос: попросят
доработа: доработать
вообщ: вообще
след: следует
разлож: разложить
полочк: полочкам
обобщ: обобщить
оп: опыт
подел: поделиться поделитесь
друг: другими
принос: приносить
чертовск: чертовски
приятн: приятно
попроб: попробуйте
угада: угадаешь
разбира: разбирается разбираетесь
вопрос: вопросе вопрос вопросы
голов: голову
фидбэк: фидбэк
так: таких
люд: людей
возможн: возможно возможности
цен: ценное
приобретет: приобретете
публикац: публикации
репутац: репутация
резюм: резюме
расскажут: расскажут
занима: занимаетесь
получ: получите
полноправн: полноправный
аккаунт: аккаунт
плюс: плюс
карм: карму
высок: высоким
профильн: профильным профильное
тем: темам тему
мож: можем
поощря: поощрять
материальн: материально
программ: программа программы
поощрен: поощрения
формат: формат форматов формату
выбра: выбрать
определ: определитесь
хот: хотите
распространен: распространенных
кажд: каждому
кратк: краткую
инструкц: инструкцию
помогут: помогут
структурирова: структурировать
текст: текст тексте
новост: новости новость
перв: первыми
узна: узнали
сбо: сбое
сет: сети
увидел: увидели
продукт: продукт
свеж: свежий
законопроект: законопроект
остальн: остальными
кейс: кейсы кейс
организова: организовали
умн: умный
дом: дом
рубл: рублей
перееха: переехали
зеланд: зеландию
код: код
распознаван: распознаванию
кив: киви
пиш: пишите
интересн: интересно интересных интересном
туториал: туториалы
справ: справились
непрост: непростой
задач: задачей
расскаж: расскажите
пункт: пунктам
реш: решить
читател: читатели
благодарн: благодарны
ретроспектив: ретроспективы ретроспективу
помн: помните
подробн: подробностях
зарожда: зарождались
вещ: вещи
котор: которым
привыкл: привыкли
кайф: кайф
почита: почитать
долг: долгими
зимн: зимними
вечер: вечерами вечер
обзор: обзоры обзор
перепробова: перепробовали
куч: кучу
моноколес: моноколес
стримингов: стриминговых
сервис: сервисов
сред: сред
обрат: обратить
вниман: внимание
мнен: мнения мнение
особ: особый
взгляд: взгляд взглядов
остр: острый
обсуд: обсудить
напиш: напишите
дума: думаете
готовьт: готовьтесь
провест: провести
справочн: справочные справочную
глубок: глубоко
изуч: изучили
сложн: сложную
готов: готовы
рассказа: рассказать
пальц: пальцах
устро: устроено
дерза: дерзайте
интерв: интервью
доступ: доступ
человек: человеку
необычн: необычным
опыт: опытом
срочн: срочно
бер: берите
охапк: охапку
задава: задавайте
ответ: ответил ответ
дайджест: дайджесты дайджест
накоп: накопилась
подборк: подборка
ссылок: ссылок
хочет: хочется
сво: своими
открыт: открытиями
вперед: вперед
любознательн: любознательные
больш: большим
кругозор: кругозором
репортаж: репортажи репортаж
попа: попали
знаков: знаковое
мероприят: мероприятие
аналитик: аналитика
улов: уловили
тренд: тренды
понима: понимаете
станет: станет
рынк: рынком
полгод: полгода
нрав: нравится
стро: строить
график: графики
диаграмм: диаграммы
обобща: обобщать
дан: данные дано данных
классн: классно
случа: случай
знает: знаете
подступ: подступиться
ин: иному
коротк: короткие
гайд: гайды
сдела: сделать
материал: материалы
полезн: полезными полезно полезный
оформ: оформить
удобн: удобно
чита: читать
облажа: облажаться
описа: описать
состав: составить
понятн: понятный
туториа: туториал
взят: взять
круч: круче
дуд: дудь
завист: зависть
исчерпыва: исчерпывающую
информативн: информативный
внятн: внятный
ещ: ещ
помоч: помочь
направ: направим направить
нужн: нужное
русл: русло
увер: уверены
сто: стоит
письм: письме письмо
ч: ч
ваш: вашего
тки: тки
план: план
редактор: редакторы
зададут: зададут
уточня: уточняющие
предложат: предложат
правк: правки
отточ: отточить
точн: точно
цел: цель
представител: представитель
компан: компании компаний
найд: найдем
спикер: спикеров
обуча: обучали
нейросет: нейросеть
пуска: пускать
кошк: кошку
найт: найти
фелинолог: фелинолога
расскажет: расскажет
психолог: психологию
котик: котиков
и: ии
инженер: инженера
прокомментир: прокомментирует
программн: программное
решен: решение
иска: искать
помож: поможем
аккредиту: аккредитуем
попаст: попасть
отправьт: отправьте
свяж: свяжемся
организатор: организаторами
попробу: попробуем
аккредитова: аккредитовать
ждем: ждем
напишет: напишете
конференц: конференции
заодн: заодно
попробует: попробуете
рол: роли
корреспондент: корреспондента
час: часа часов
краж: кража
учетн: учетных
администратор: администратора
касан: касания
помощ: помощью
пут: путем
злоупотреблен: злоупотребления
количеств: количество
рев: ревью
программистск: программистском
ретр: ретро
компьютер: компьютер
уровн: уровня
рад: радио
рк: рк
процессор: процессором
плат: плате
адаптивн: адаптивный
многоязычн: многоязычный
компонент: компонент
футер: футера
создан: создание
использован: использование
перспектив: перспективы
применен: применения
войт: войти
регистрац: регистрация
раздел: разделы
хаб: хабы
песочниц: песочница
информац: информация
устройств: устройство
сайт: сайта
документ: документы
соглашен: соглашение
конфиденциальн: конфиденциальность
услуг: услуги
корпоративн: корпоративный
блог: блог
медийн: медийная
реклам: реклама
нативн: нативные
проект: проекты
образовательн: образовательные
стартап: стартапам
мегапроект: мегапроекты
яндекс: яндекс
дзен: дзен
настройк: настройка
язык: языка
техническ: техническая
поддержк: поддержка
вернут: вернуться
стар: старую
верс: версию
neo: neo
habr: habr
team: team
corp: corp
lsass: lsass
kekeo: kekeo
credssp: credssp
risc: risc
omdazz: omdazz
vue: vue
uwb: uwb
facebook: facebook
twitter: twitter
vk: vk
telegram: telegram
youtub: youtube
