хабр: хабр
откр: открыть
список: список
стат: стать внука разделы
автор: автором компании сайта
поток: потоки
разработк: разработка
администрирован: администрирование
дизайн: дизайн
менеджмент: менеджмент
маркетинг: маркетинг
научпоп: научпоп
поиск: поиск
профил: профиль
обнов: обновить
час: часов статью
дайджест: дайджест
новост: новостей статьи
недел: неделю
писа: писали
уровен: уровень
сложност: сложности
прост: простой
прочтен: прочтение
мин: мин
количеств: количество
просмотр: просмотров
научн: научно
популярн: популярное
голос: голосов
добав: добавить
закладк: закладки
комментар: комментарии комментарий
скопирова: скопировать
ссылк: ссылку
мо: моему далековато
мозг: мозг структур
правильн: правильно людей
работа: работает
предсказыва: предсказывать
дальн: дальнейшее
развит: развитие
событ: событий
запомина: запоминать
ответ: ответить вопросы
ещ: ещ
измен: изменен
естествен: естественный посчитать
отбор: отбор
предпочита: предпочитает
люд: людям взрослых
искусствен: искусственный тся
интеллект: интеллект искусственному
программист: программист
летн: летним
стаж: стажем
последн: последнее
внимательн: внимательно
наблюда: наблюдаю
стремительн: стремительно
адаптир: адаптируется
наш: нашем
мир: мире
внук: внук моего
котор: которому интеллекту
исполн: исполнилось
разговарив: разговаривая
слуш: ним
вопрос: слушая
пор: ответы
намн: порой
здравомыслен: намного
взросл: здравомысленные
язык: правильный настройка
анализиру: язык
способн: анализируя
обучен: способности
мысл: обучению
вывод: мысли
вс: выводы
прихож: вс
реш: прихожу
разум: решил
момент: разум
посчита: момент
круг: естественным
замкн: круг
тся: замкн
име: которым
дел: имеем
далековат: дело
показа: часа
предыдущ: показать
как: предыдущий
параметр: каким
сравнива: параметрам
секрет: сравнивали
подел: секрет
методик: поделитесь
сравнен: методиками
прич: сравнения
выбира: прич
культур: выбирал развиваться
языков: культуре
сред: языковой
предсто: среде
развива: предстоит
проника: культура
формир: проникает
личност: формирует
некотор: личность
род: некотором
бессмерт: роде
достижен: бессмертие
интеллектуальн: достижения
капита: интеллектуальный
возвраща: капитал
жизн: возвращаются
нов: жизни
тел: новые
отлич: тела
и: отличии
имеет: ии
множеств: имеет
предопредел: множество
нных: предопредел
эволюц: нных
готов: эволюцией
поведенческ: готовых
особен: поведенческих
структур: особенностей
определя: мозге
мотив: определяющих
интерес: мотивы
оценива: интересы
полноправн: оценивали
пользовател: полноправные
оставля: пользователи
войд: оставлять
аккаунт: войдите
войт: аккаунт
регистрац: войти
раздел: регистрация
хаб: новости
компан: хабы авторов
песочниц: авторы
информац: песочница
устройств: информация
сайт: устройство
документ: компаний
соглашен: документы
конфиденциальн: соглашение
услуг: конфиденциальность
корпоративн: услуги
блог: корпоративный
медийн: блог
реклам: медийная
нативн: реклама
проект: нативные
образовательн: проекты
программ: образовательные
стартап: программы
спецпроект: стартапам
яндекс: спецпроекты
дзен: яндекс
настройк: дзен
техническ: языка
поддержк: техническая
вернут: поддержка
стар: вернуться
верс: старую
sly: sly
g: g
rss: rss
javian: javian
saipr: saipr
orbit: orbit
engin: engine
facebook: facebook
twitter: twitter
vk: vk
telegram: telegram
youtub: youtube
habr: habr
