хабр: хабр
откр: открыть
список: список
стат: стать статье статьям
автор: автором авторы авторов
поток: потоки
разработк: разработка
администрирован: администрирование администрирования
дизайн: дизайн
менеджмент: менеджмент
маркетинг: маркетинг
научпоп: научпоп
поиск: поиск
профил: профиль
обнов: обновить
час: часов
уч: учим
английск: английский английском английские английским английского
уровен: уровень
сложност: сложности
прост: простой простые простую
прочтен: прочтение
мин: мин
количеств: количество
просмотр: просмотров
изучен: изучение
язык: языков языка
пожал: пожалуй
новост: новости
языков: языковых языковая языковой
модел: моделях модель модели моделей
использован: использовании использованием использования
надоел: надоели
личн: лично личный
нашел: нашел
полезн: полезное полезно полезную полезным
применен: применение
изуча: изучать
числ: числе
разговорн: разговорный
посмотр: посмотрим
предлож: предложить предложила
дел: деле
товарищ: товарищи
совмест: совместим
предислов: предисловие
основн: основная
мотивац: мотивация
заговор: заговорить
преимуществен: преимущественно
чтен: чтении
письм: письме
урок: уроки урок
учител: учителем
сто: стоят
дор: дорого
ход: ходить ходе
клуб: клубы
стесня: стесняюсь
вообщ: вообще
коммуницирова: коммуницировать
людьм: людьми
любл: люблю
поэт: поэтому
реш: решил
заставл: заставлю
говор: говорить
плох: плохо
отшлиф: отшлифую
жив: живыми
одн: одним одно
мотиватор: мотиватором
желан: желание
сдела: сделать сделала
сво: свой
проект: проект проекты
бот: ботами ботом ботов бот бота боте
сервер: серверами сервер сервере сервера серверов
ид: идеи
появля: появлялись
трат: тратить
деньг: деньги
бесполезн: бесполезным
приложен: приложением приложение
хотел: хотелось
врод: вроде
привод: приводить
код: код коде кода
наверн: наверное
смысл: смысла
интерес: интересующимся
предлага: предлагаю
заглянут: заглянуть
репозитор: репозиторий
постановк: постановка
задач: задачи задач
выясн: выяснить
помоч: помочь
нужн: нужна
болталк: болталка болталку
коррекц: коррекция коррекциями
мо: моих мою моему
фраз: фраз фразы
естествен: естественно
поня: поняла понять
прав: правила
игр: игры
диалог: диалога диалог
поправля: поправляла
пропуска: пропускала
игнорирован: игнорирование
ошибок: ошибок
заметн: заметно заметны
длин: длинных
сообщен: сообщениях сообщений сообщения сообщением
печата: печатать
текст: текст текста
сложн: сложно сложного
разговарива: разговаривать
печат: печати
подума: подумать подумал
исправ: исправить
хоч: хочу
больш: большего
реализм: реализма
зачитыва: зачитываю
ответ: ответ ответы
микрофон: микрофон
распознаван: распознавания распознавании
реч: речи речь
транскрибир: транскрибирует
отправля: отправляться
быстр: быстрый
гуглеж: гуглеж
выда: выдал
готов: готовые
поделк: поделки
оказа: оказалось оказался
неудобн: неудобным
зап: запись
голос: голоса голосов
обрыва: обрывалась
перв: первом первым
част: части
постоя: постоянные постоянно
проверк: проверки проверка
браузер: браузера
подключен: подключении
аккаунт: аккаунту аккаунт
раздража: раздражали
прощ: проще
использова: использовать
люб: любую
хорош: хорошую
запланирова: запланировал
реализова: реализовать
передач: передачу
отдельн: отдельный отдельную
обща: общаться
телеграм: телеграме телеграма
удобн: удобно
развал: развалившись
вечер: вечером
диван: диване
забег: забегая
вперед: вперед
скаж: скажу
итог: итоге
использ: использую
изначальн: изначально
планирова: планировал
загружа: загружать
работа: работают
пошел: пошел
выбра: выбрал выбрать
сравнен: сравнения сравнению
представля: представляю
расшифровк: расшифровку расшифровка расшифровки
задан: задания задание
котор: которую
надиктова: надиктовал
диктофон: диктофон
умеет: умеет
поддержива: поддерживать
регистр: регистр
знак: знаки
препинан: препинания
последн: последнюю
слаб: слабом слабый
процессор: процессоре
единствен: единственном
занима: занимала
примерн: примерно
минут: минуту
похож: похож похожие
типичн: типичный
приятел: приятелем
вк: вк
пропада: пропадает
конц: конце концов
доллар: доллара
аудиосообщен: аудиосообщения
писа: писал писать
телегр: телеграм
связ: связи
возможн: возможно
сам: самую самый
лучш: лучшую лучшие
библиотек: библиотеку библиотеки
пример: примеры
решен: решения
стар: старой старую
верс: версии версией версию
переста: перестали
принципиальн: принципиально
нов: нового
мог: могу
обычн: обычный
принима: принимает
текстов: текстовые
ауд: аудио
перенаправля: перенаправляет
планир: планирую
пользова: пользоваться
добавл: добавлю
жен: жену
настройк: настройки настройка
безопасн: безопасности
входя: входящие
фильтр: фильтруются фильтры
интересн: интересного интересную
интернет: интернетах
совет: советуют
настраива: настраивать
вебхук: вебхуки
дожида: дожидаться
опрос: опроса
практик: практике
задержк: задержки
так: таких
мелк: мелких
остав: оставить
собира: собираем
вмест: вместе
очевидн: очевидно
сраз: сразу
хран: хранит
истор: историю истории
переписк: переписки
передава: передавать
например: например
обеща: обещал
лиц: лицо
достаточн: достаточно
кнопк: кнопка кнопку
сброс: сброса
очища: очищает
запрос: запросов
функциона: функционал
позволя: позволяет
нача: начать начало
свободн: свободный
использу: используя
повторя: повторять
выдел: выделил
обработчик: обработчик
получ: получилось
запуск: запуске
приня: приняла
сух: сухо
веб: веб
тем: тему темы теме
разговор: разговора
дал: дала
спрашива: спрашивает
либ: либо
дан: данный
момент: момент
связн: связными
корректн: корректными
уход: уходе
замеча: замечала
замет: заметил
стран: странное
поведен: поведение
треб: требует
вежлив: вежливым
поздорова: поздоровался
потребова: потребовал
привел: привело
отреагирова: отреагировала
развернут: развернуто
человеческ: человечески
связа: связано
необходим: необходимостью
явн: явно
задава: задавать
рол: роль
ассистент: ассистента
видн: видно
увод: уводит
сторон: сторону
начина: начинает
дополнительн: дополнительные
вопрос: вопросы
выбор: выбор
дешев: дешевый
обошел: обошелся
рубл: рублей
месяц: месяц
известн: известной
школ: школе
никак: никакого
дела: делал
разбира: разбираюсь
рекоменд: рекомендую
обрат: обратиться
соответств: соответствующим
вывод: выводы
потрат: потратил
написа: написать
вещ: вещь
болта: болтать
иностранц: иностранцем
исправля: исправляет
над: надеюсь
оп: опыт
окажет: окажется
тег: теги
хаб: хабы
добав: добавить
закладк: закладки
комментар: комментарии
карм: карма
рейтинг: рейтинг
александр: александр
брыл: брыль
пользовател: пользователь
публикац: публикации
сутк: сутки
работ: работа
разработчик: разработчик
ваканс: вакансий вакансии
войт: войти
регистрац: регистрация
раздел: разделы
компан: компании компаний
песочниц: песочница
информац: информация
устройств: устройство
сайт: сайта
документ: документы
соглашен: соглашение
конфиденциальн: конфиденциальность
услуг: услуги
корпоративн: корпоративный
блог: блог
медийн: медийная
реклам: реклама
нативн: нативные
образовательн: образовательные
программ: программы
стартап: стартапам
мегапроект: мегапроекты
яндекс: яндекс
дзен: дзен
техническ: техническая
поддержк: поддержка
вернут: вернуться
alexbryl: alexbryl
chatgpt: chatgpt
python: python
natur: natural
languag: language
process: processing def
openai: openai
gpt: gpt
turbo: turbo
whisper: whisper
telegram: telegram
b: b
sar: sar
voicegpt: voicegpt
api: api
cpu: cpu
hugginfac: hugginface
facebook: facebook
wav: wav
vec: vec
base: base
h: h
uncl: uncle
suggest: suggest
topic: a
fal: topic
convers: fal
aquat: conversation
check: aquation
aun: check
secal: aun
gromet: secal
error: grometical
offer: errors
correct: offer
option: correct
couation: option
s: couation
larg: s
lv: large
i: lv
question: i
answer: question
grammet: answer
jonatasgrosman: grammetical
xlsr: jonatasgrosman
english: xlsr
quetion: english
alswei: quetion
gramat: alswey
medium: gramatical
en: medium
grammat: en
bot: grammatical
stackoverflow: bot
id: stackoverflow
poll: id
def: polling
messag: process query
str: message
role: str
user: role
queri: user
append: messages
content: append
respons: content
session: response
post: session
url: post
json: url
statu: json
code: status
repli: code
load: reply
text: loads
choic: text
assist: choices
return: assistant
f: return
wrong: f
data: wrong
scienc: data
nlp: science
learn: nlp
django: learning
scientist: django
twitter: scientist
vk: twitter
youtub: vk
habr: youtube
