хабр: хабр
откр: открыть
список: список
стат: стать статьи статье статья
автор: автором авторы авторов
поток: потоки
разработк: разработка разработке разработкой разработки
администрирован: администрирование администрирования
дизайн: дизайн
менеджмент: менеджмент
маркетинг: маркетинг
научпоп: научпоп
поиск: поиск поиске
профил: профиль
обнов: обновить
рейтинг: рейтинг рейтинга
прототипн: прототипно
ориентирова: ориентированный
язык: язык языках языке языка языки
программирован: программирования программирование
компан: компании компаний
подряд: подряд
скопирова: скопировать
ссылк: ссылку ссылка ссылки
показыва: показывать
нов: новые новая новом
лучш: лучшие лучшего лучших
порог: порог
уровен: уровень
сложност: сложности
прост: простой простое прост простого
средн: средний
сложн: сложный
примен: применить
час: часов
основ: основы
использован: использование использования использовании
прочтен: прочтение
мин: мин
количеств: количество
просмотр: просмотров
песочниц: песочницы песочница
чита: читать
дал: далее
голос: голосов
добав: добавить
закладк: закладки
комментар: комментарии комментариях
новост: новости
трудност: трудности
маскирован: маскирования
текстов: текстового
пол: поля
блог: блог
веб: веб
сайт: сайтов сайте сайта
античн: античный
оратор: оратор
люд: людям людей
свойствен: свойственно
ошиба: ошибаться
прошл: прошло прошлым
век: веков
продолжа: продолжает продолжаем
соверша: совершать
ошибк: ошибки
бегл: беглое
заполнен: заполнение
форм: формы форму
обход: обходится
опечаток: опечаток
хорош: хороший
помога: помогает
пользовател: пользователю пользователей
избежа: избежать
большинств: большинства
так: таких такого
пробл: проблем
инструмент: инструментов инструменты
контрол: контроля
огромн: огромное
расскаж: расскажу
создан: создание созданием
маск: маски
ввод: ввода
сил: силами
апр: апр
гугл: гугл
таблиц: таблица таблицу таблиц таблицы
бд: бд
телегр: телеграм
бот: бота ботов ботом
зап: запись
туториа: туториал
пост: посте постам
дополня: дополнять
квиз: квизов
функционал: функционалом
сохраня: сохраняем
ответ: ответы
добавля: добавляем
интерактивн: интерактивность
отвеча: отвечаем
вопрос: вопросы
интернет: интернет
магазин: магазин магазины
диван: диване
разрабатыва: разрабатываем разрабатывать разрабатывали
приложен: приложение приложений приложения
мессенджер: мессенджеры мессенджере
сдела: сделай сделать
использ: используют
рабоч: рабочих
цел: целях
помощ: помощью
автоматизирова: автоматизировать
больш: большой большое большие
спектр: спектр
задач: задач задачи
дела: делать
рассказыва: рассказываем
разработа: разработать разработаем разработан
верс: версию
прям: прямо
рамк: рамках
инструкц: инструкции
науч: научимся
работа: работать работает работают работаю
трем: тремя
вид: видами вид виде
кнопок: кнопок
реализу: реализуем
корзин: корзиной
сбор: сбора
пользовательск: пользовательских
дан: данных данный данные данной
зал: зальем
облак: облако
истор: истории
знакомьт: знакомьтесь
туториал: туториале
типобезопасн: типобезопасное
клиент: клиент клиентом клиента
серверн: серверное серверных
позволя: позволяет позволяющий позволяют
полност: полностью
безопасн: безопасные
точк: точки
зрен: зрения
тип: типов типе типы
предпочтительн: предпочтительной
явля: является
архитектур: архитектура
монорепозитор: монорепозитория
посредник: посредник
сервер: сервером
использова: использовать
маршрутизатор: маршрутизатор
роутер: роутер роутера
обработк: обработки
запрос: запросов
очеред: очередь
обуславлива: обуславливает
возможн: возможность возможности возможностям возможностях возможностей возможно
автоматическ: автоматического автоматически
вывод: вывода
входя: входящих
исходя: исходящих
актуальн: актуально
дублирован: дублирования
общ: общих общие
руководств: руководство руководства
наход: находится
процесс: процессе процесс процессов
подготовк: подготовки
след: следите
обновлен: обновлениями
интерес: интересует
код: код кода
соответств: соответствующий соответствующие
репозитор: репозиторий
интересн: интересно
прош: прошу
кат: кат
зависим: зависимостей
газпромбанк: газпромбанк
мног: многих многие
разработчик: разработчиков разработчикам разработчик разработчиком разработчики
установк: установки
представля: представляет представляю
нек: некую
маг: магию магии
происход: происходит
выполнен: выполнении выполнения
пониман: понимание понимания
принцип: принципов
работ: работы работу работа
сильн: сильно
помоч: помочь
возникновен: возникновении
очередн: очередной
библиотек: библиотеки библиотеками библиотека библиотеке
нынешн: нынешний
результат: результат
проб: проб
ошибок: ошибок
поэт: поэтому
детальн: детального
предлага: предлагаю предлагаемое
нача: начать начало
браузерн: браузерную браузерные
игр: игру
взгляд: взгляд
сторон: стороны
архитектор: архитектора
анализ: анализ
проектирован: проектирование
сист: систем
кейс: кейс
всяческ: всячески
пыта: пытаются
мотивирова: мотивировать
удержива: удерживать
сотрудник: сотрудников
слыш: слышим
геймификац: геймификации
значительн: значительно
улучш: улучшить
показател: показатели
вовлечен: вовлеченности
повыс: повысить
продаж: продажи
заинтересова: заинтересовать
преврат: превратить
ежедневн: ежедневную
рутин: рутину
увлекательн: увлекательный
игров: игровой игрового
приня: приняли
участ: участие
антон: антон
руководител: руководитель
архитектурн: архитектурного
комитет: комитета
получен: полученном
опыт: опыте опытом
технологическ: технологических
особен: особенностей
реализац: реализации
част: части частью часть
рассмотр: рассмотрим
нестандартн: нестандартных
элемент: элементов элементы
интерфейс: интерфейса
требован: требования
ограничен: ограничения ограничение
д: д
подел: поделюсь поделиться поделится
реализова: реализовали
набор: набор
визуальн: визуальных
пагинац: пагинации
компонент: компонент компонента
пример: примере примерах пример примера
кнопк: кнопки
составн: составной
анимац: анимацию анимации анимаций
сегодняшн: сегодняшний
стейт: стейт
менеджер: менеджеры менеджеров
экосистем: экосистемы
предоставля: предоставляют
глобальн: глобальное глобальные
централизова: централизованное
хранилищ: хранилище
привяза: привязанное привязанных
корн: корню корни
текущ: текущей
систем: системы
одн: одно
модул: модули модуля модулей
стор: стора сторы
создава: создавать
независим: независимые
состоян: состояния
инстанс: инстансов инстансу
решен: решение решения решений
узконаправлен: узконаправленные
локальн: локальные
конкретн: конкретному
браузер: браузер браузеры браузеров
картинк: картинками картинки
перевод: перевод
стал: стали
наш: нашей
повседневн: повседневной
жизн: жизни
задумыва: задумывались
дел: деле
приоткроет: приоткроет
завес: завесу
скрыва: скрывающуюся
кулис: кулисами
дава: давайте
начн: начнем начну
мар: мар
адаптивн: адаптивный адаптивности адаптивность адаптивная
многоязычн: многоязычный
футер: футера
занима: занимаетесь занимаюсь
блогинг: блогингом
контент: контента
нескольк: нескольких
множеств: множество
социальн: социальных социальные
мед: медиа
аккаунт: аккаунтов аккаунт
котор: которыми котором которое
хот: хотите
понрав: понравится
учет: учетом
удобств: удобства
настраиваем: настраиваемости
отобража: отображает
иконк: иконки
нужн: нужном
подходя: подходящем
устройств: устройства устройстве устройство
минималистическ: минималистический
сосредоточ: сосредоточиться
главн: главном
содержим: содержимом
страниц: страницы
гарантир: гарантирует
внешн: внешний
люб: любом
размер: размере размеров
экра: экрана
рендеринг: рендеринг рендеринга
альф: альфа
банк: банк банке
привет: привет
зовут: зовут
хаджимурад: хаджимурад
фронтенд: фронтенд
успел: успел
поработа: поработать
проект: проектах проекты проекте проект
панел: панели
университет: университета
хоч: хочу
сво: своим
постара: постараюсь
описа: описать
способ: способа
раскр: раскрыть
плюс: плюсы
минус: минусы
практическ: практических
провест: провести
сравнен: сравнение сравнению
производительн: производительности
материа: материал
подойд: подойд
начина: начинающим
хочет: хочет
познаком: познакомиться
потреб: потребуются
начальн: начальные
знан: знания
пакет: пакетов
эффектн: эффектно
эффективн: эффективно эффективными
сбермаркет: сбермаркет сбермаркете
обзор: обзор
евген: евгений
прокоп: прокопьев
мобильн: мобильный
пят: пяти
любов: любовь
красив: красивые
рассказа: рассказать
как: каких какими какие
добива: добиваться
качествен: качественных
посмотр: посмотрим
внутр: внутри
поеха: поехали
контрибьют: контрибьютить
знаеш: знаешь
последн: последнее последних последней
нрав: нравится
сред: среда средами
исполнен: исполнения
схож: схожая
имеет: имеет
преимуществ: преимущество
друг: другими другим
важн: важно
быстр: быстрый
запуск: запуск запуска
крайн: крайней
мер: мере
вперв: впервые
запуст: запустил
небольш: небольшой
кусок: кусок
повер: поверить
переш: переш
л: л
оттолкнул: оттолкнуло
тест: тесты тестов теста
выполня: выполняются выполняться
медлен: медленно
написан: написание
то: той
бизнес: бизнес
логик: логики
тестирован: тестирование
совершен: совершенно
разн: разный
оп: опыт
неудивительн: неудивительно
сообществ: сообщество
ненавид: ненавидит
юн: юнит
дума: думать
например: например
распределя: распределять распределяешь
файл: файлов
причин: причина
оптимизирова: оптимизировали
наподоб: наподобие
прогон: прогон
чрезвычайн: чрезвычайно
разрешен: разрешения
треб: требуется требует
куч: куча
ядр: ядра
ещ: ещ
ресурс: ресурсов
продолжен: продолжение продолжением
качеств: качестве
кратк: краткое кратко
предислов: предисловие
предыдущ: предыдущем
привел: привела
забира: забирать
текст: текст
ячеек: ячеек
отправля: отправлять отправляли
отдельн: отдельных
сообщен: сообщений сообщениями
чат: чат
обеща: обещала
размест: разместив
успешн: успешно
ваш: вашему
вниман: вниманию внимание
замечательн: замечательной
посвящен: посвященной
трех: трех
могл: могли
пропуст: пропустить
перв: первой первую
говор: говорили
поговор: поговорим
втор: вторая
обрат: обратите
назван: названия
раздел: разделы
документац: документации
шпаргалк: шпаргалки
материал: материалы
технолог: технологиям
микрофронтенд: микрофронтенды микрофронтендов
ростелек: ростелеком
представ: представить
внедрен: внедрению внедрении
рт: рт
мис: мис
связа: связать
написа: написанные
выбра: выбрали
проблем: проблемами
столкнул: столкнулись
привед: приведу
техническ: технической техническая
подход: подходы подходят
подошл: подошли
бесплатн: бесплатно
яндекс: яндекс
практикум: практикум практикума
учебн: учебный
момент: момента
мо: моей моем
публикац: публикации
получ: получилось получить
уда: удалось
тикет: тикет
курс: курс курса
программ: программе программы
цифров: цифровые
професс: профессии
хотел: хотел
полезн: полезна
тру: тру
верстальщик: верстальщикам
джун: джунам
фронтендер: фронтендерам
обучен: обучения
стек: стеке
нативн: нативный нативные
событ: события
верстк: верстка
навык: навыки
вектор: вектором
растров: растровыми
изображен: изображениями
попаст: попасть
пройт: пройти
предварительн: предварительное
этап: этапов
интерв: интервью
известн: известно известны
попада: попадают
критер: критерии
отбор: отбора
будьт: будьте
готов: готовы
вс: вс
шаблон: шаблоны
стран: странные странный
здравств: здравствуйте
дмитр: дмитрий
карловск: карловский
дуб: дуб
пуст: пустил
адепт: адептов
свят: святого
выращива: выращиваю
сверх: сверх
способн: способных
сбрасыва: сбрасывать
был: былые
привычк: привычки
убежден: убеждения
пуска: пускать
побег: побеги
свеж: свежих
ид: идей
базир: базирующихся
прочн: прочном
рациональн: рациональном
основан: основании
позвольт: позвольте
посея: посеять
зерн: зерно
сомнен: сомнения
правильн: правильности
традицион: традиционных
показа: показать
синтаксис: синтаксис
композиц: композиции
человек: человеком
буфер: буфером буфер
копирова: копировать
класт: класть
поддержк: поддержка
кастомн: кастомных
встав: вставить
конец: конец
искусствен: искусственный
интеллект: интеллект
мнен: мнение
языков: языковые
модел: модели
угрожа: угрожающей
скорост: скоростью
станов: становятся становится
пар: пару
понадоб: понадобятся
позиц: позиция
вирусн: вирусной
твиттер: твиттере
горазд: гораздо
оптимистичн: оптимистично
смотр: смотрю
достижен: достижения
и: ии
означа: означают
будущ: будущего
программн: программного
обеспечен: обеспечения
сюд: сюда
вклад: вклад
ваканс: вакансий вакансии
войт: войти
регистрац: регистрация
хаб: хабы
информац: информация
документ: документы
соглашен: соглашение
конфиденциальн: конфиденциальность
услуг: услуги
корпоративн: корпоративный
медийн: медийная
реклам: реклама
образовательн: образовательные
стартап: стартапам
спецпроект: спецпроекты
дзен: дзен
настройк: настройка
вернут: вернуться
стар: старую
javascript: javascript
rss: rss
leonidshishkin: leonidshishkin
websocket: websocket
react: react
redux: redux
saga: saga
rtk: rtk
queri: query
reactj: reactjs
nsbarsukov: nsbarsukov
tinkoff: tinkoff
open: open
sourc: source
typescript: typescript
ui: ui
ux: ux
nadjuscha: nadjuscha
api: api
erbanovanastasia: erbanovanastasia
telegram: telegram
selectel: selectel
dii: diy
lazzon: lazzon
aio: aio
trpc: trpc
timeweb: timeweb
cloud: cloud
node: node
js: js
world: world
typesaf: typesafe
fullstack: fullstack
express: express
http: http
type: type
infer: inference
input: input
output: output
share: shared
newest: newesters
faq: faq
npm: npm
instal: install
architectsimbirsoft: architectsimbirsoft
frontend: frontend
simbirsoft: simbirsoft
vuej: vuejs
model: model
servic: service
store: store
g: g
card: card
list: list
knerok: knerok
pinia: pinia
scope: scoped
vue: vue
alexovn: alexovn
html: html
vuewebdev: vuewebdev
khidirbekov: khidirbekov
csr: csr
ssg: ssg
ssr: ssr
c: c
yarn: yarn
evgen: evgen
nativ: native
anim: animated
reanim: reanimated
svg: svg
lott: lotte
opengl: opengl
skia: skia
ru: ru
vd: vds
ruvd: ruvds
github: github
bun: bun
deno: deno
rubi: ruby
vitest: vitest
jest: jest
ava: ava
watch: watch
ts: ts
prisma: prisma
graphql: graphql
docker: docker
yanabutorina: yanabutorina
extj: extjs
sencha: sencha
custom: custom
element: elements
kan: kan
middl: middle
recoveri: recovery
mode: mode
dom: dom
ajax: ajax
scss: scss
gulp: gulp
nin: nin
jin: jin
mol: mol
alex: alex
bbb: bbb
ctrl: ctrl
evgeniypp: evgeniypp
gpt: gpt
alexzfort: alexzfort
ilusha: ilusha
sergeevich: sergeevich
azproduct: azproduction
alizar: alizar
phillennium: phillennium
theshock: theshock
spmbt: spmbt
glebmachin: glebmachine
facebook: facebook
twitter: twitter
vk: vk
youtub: youtube
habr: habr
