хабр: хабр хабре
откр: открыть
список: список
стат: стать статью статье статьи
автор: автором авторов автор авторы
поток: потоки поток потоке
разработк: разработка разработке
администрирован: администрирование
дизайн: дизайн
менеджмент: менеджмент
маркетинг: маркетинг
научпоп: научпоп
поиск: поиск
профил: профиль
обнов: обновить
час: часов
дайджест: дайджест
новост: новостей новостям новости
недел: неделю недели
писа: писали
уровен: уровень
сложност: сложности
прост: простой
прочтен: прочтение
мин: мин
количеств: количество количества
просмотр: просмотров
научн: научно
популярн: популярное популярную
здравств: здравствуйте
вячесла: вячеслав
голован: голованов
курир: курирую
сред: среди
мо: моих
задач: задач
увеличен: увеличение
публикац: публикаций публикации
числ: числе
привлечен: привлечение
нов: новых новое новый новой новую
хорош: хороших
хотел: хотели
написа: написать
тем: тему
боя: боялись
нача: начать начали
знак: знак
может: можете
обсуд: обсудить
личн: личные
сообщен: сообщения
песочниц: песочницу песочница
кинут: кинуть
ссылк: ссылку
пройд: пройдусь
уходя: уходящей
наш: нашей нашу наших
редакц: редакции
сто: стоило
освет: осветить
подробн: подробнее
получ: получилось получить
суперспособн: суперспособностей
хим: химия химии
разъеда: разъедающая
озонов: озоновый озоновой озоновом озоновому
сло: слой слое слою
непонятн: непонятным
образ: образом
возвраща: возвращается
атмосфер: атмосферу атмосфере
несмотр: несмотря
запрет: запрет
снимк: снимке
сдела: сделанном
сентябр: сентябре
площад: площадь
антарктическ: антарктической
дыр: дыры дыру
составля: составляет
млн: млн
км: км
химическ: химические химических химической
веществ: вещества веществ
запрещ: запрещ
нны: нные
продела: проделали
земл: земли
прежн: прежнему
накаплива: накапливаются
угрожа: угрожающей
скорост: скоростью
согласн: согласно
исследован: исследованию исследование исследований исследования
опубликова: опубликованному опубликована опубликовали
журнал: журнале
широк: широко
использова: использовались
систем: системах
кондиционирован: кондиционирования
воздух: воздуха
охлажден: охлаждения
должн: должны
постепен: постепенно
вывед: выведены
употреблен: употребления
мир: мире мир
уч: уч
ны: ные
удивлен: удивлением
обнаруж: обнаружили
концентрац: концентрация
нескольк: нескольких
вид: видов видят
выросл: выросла
достигнув: достигнув
рекордн: рекордно
высок: высокого
уровн: уровня
виновник: виновником
альтернативн: альтернативные альтернативная
хладагент: хладагенты
замен: заменить
озоноразруша: озоноразрушающие
предполага: предполагает
исследовател: исследователи исследователей исследователь
найт: найти
откуд: откуда
происход: происходит
утечк: утечка
последн: последние
десятилет: десятилетий
уда: удалось
доб: добиться
значительн: значительного
восстановлен: восстановления
выброс: выбросы
продолжат: продолжат
раст: расти
свест: свести
част: часть
достигнут: достигнутого
прогресс: прогресса
усугуб: усугубить
изменен: изменение
климат: климата
науч: научились научила научиться
след: следить
митохондр: митохондриями митохондрии митохондрий митохондриях
коллаборац: коллаборация
физик: физиков
химик: химиков
биолог: биологов
наночастиц: наночастицы наночастиц
видет: видеть
энергетическ: энергетические
фабрик: фабрики
клетк: клетки
помощ: помощью
гигантск: гигантского
комбинацион: комбинационного
рассеян: рассеяния
воспроизводим: воспроизводимый
чувствительн: чувствительный
подход: подход
поможет: поможет
сенсор: сенсоров
диагностик: диагностики диагностике
заболеван: заболеваний
ран: ранних
стад: стадиях
работ: работа работе работы работу
сбо: сбои
причин: причиной
больш: большого
патолог: патологий
например: например
нарушен: нарушений
нервн: нервной
сердечн: сердечно
сосудист: сосудистой
сист: систем
метаболическ: метаболических
онкологическ: онкологических
провед: проведено
точн: точного
метод: метода
позволя: позволяющего
отсканирова: отсканировать
интактн: интактных
существова: существовало
способ: способа
поня: понять
правильн: правильно правильной
ид: ид
перенос: перенос
электрон: электронов
состоян: состояние
отдельн: отдельных
переносчик: переносчиков переносчик
связа: связано
производств: производством
клеточн: клеточной
энерг: энергии
запуск: запуском
спектроскоп: спектроскопии
гкр: гкр
получа: получать
информац: информацию информация
структур: структуре
молекул: молекул
нанес: нанес
нных: нных
подложк: подложку подложки
использован: использования использование
биомедицинск: биомедицинской
важн: важно
интенсивн: интенсивный
сигна: сигнал
групп: групп группа
находя: находящихся находящегося
внутр: внутри
органелл: органелл
клеток: клеток
руководств: руководством
надежд: надежды
браж: браже
мгу: мгу
совместн: совместно
коллег: коллегами коллеги
мфти: мфти
разработа: разработала разработали
основ: основе
изучен: изучения
цитохром: цитохрома
замет: заметили
определ: определ
нно: нной
конфигурац: конфигурации
серебрян: серебряных
высокоинтенсивн: высокоинтенсивный
смогл: смогли
увидет: увидеть
белок: белок
сюжет: сюжет
терминатор: терминатора
повтор: повториться
реальн: реальной
жизн: жизни
эволюц: эволюция
пут: пут
естествен: естественного естественный
отбор: отбора отбор
привест: привести
эгоистичн: эгоистичному эгоистичное
поведен: поведению поведение
искусствен: искусственного искусственный
интеллект: интеллекта интеллект
поскольк: поскольку
стрем: стремится
выж: выжить
утвержда: утверждает утверждаем
дэн: дэн
хендрикс: хендрикс
директор: директор
американск: американского американская
центр: центра
безопасн: безопасности безопасного
и: ии
назван: названием
предпочита: предпочитает
люд: людям
созд: созда
стимул: стимулы
агент: агентов
действова: действовать
вопрек: вопреки
интерес: интересам
человек: человека
аргумент: аргумент
основа: основан
наблюден: наблюдениях
перв: первых
доминир: доминирующей
сил: силой
развит: развитии
втор: вторых
имеет: имеет
тенденц: тенденцию
порожда: порождать
заяв: заявил
исполн: исполнилось
дво: двое
мужчин: мужчин
созда: создали
технологическ: технологическую
компан: компанию компания компаний компании
необычн: необычном
мест: месте
одн: одному
основател: основателей основатель
брос: бросил бросить
гарвардск: гарвардский
университет: университет университета
фактическ: фактически
убед: убедил
друг: друга
гарвард: гарвард
штат: штата штат
вашингтон: вашингтон
перееха: переехали
альбукерк: альбукерке
нью: нью
мексик: мексико
сво: свой
бизнес: бизнес
двум: двумя
людьм: людьми
билл: билл
гейтс: гейтс
нын: ныне
покойн: покойный
пол: пол
алл: аллен
апрел: апреля
официальн: официально официальной
вероятн: вероятно
подозрева: подозревал
станет: станет
сам: самых
крупн: крупных
влиятельн: влиятельных
прош: прош
л: л
й: й
рожден: рождения
праздн: празднует
событ: событие
размах: размахом
отмеча: отмечает отмечают
страниц: странице
логотип: логотипом
ретр: ретро
стил: стиле
инженер: инженеры инженерии
аккумулятор: аккумуляторы
вод: воды
техасск: техасского
увелич: увеличили
мкост: мкость
электрод: электродов
батар: батарей батареи
водн: водной
содержа: содержащих
металл: металлов
отлича: отличаются
лит: литий
ион: ионных ионные
кобальт: кобальт
ных: ных
исслед: исследует исследующие
безметаллов: безметалловые
лучш: лучшего лучшие
контрол: контроля
внутрен: внутренней
цепочк: цепочкой
поставок: поставок
поставля: поставляются
стран: стран
предотврат: предотвратит
возгоран: возгорание
профессор: профессор
доктор: доктор
джод: джоди
луткенхаус: луткенхаус
доцент: доцент
дэниел: дэниел
табор: табор
вывод: выводы
безлитиев: безлитиевых
батаре: батареях батарея
пожар: пожаров
будущ: будущем
дефицит: дефицита
материал: материалов материалы
цен: цена
сильн: сильно сильные
вырастет: вырастет
смож: сможем
перейт: перейти
поставк: поставки
необходим: необходимых
стабильн: стабильными
производ: производить
сша: сша
изготовлен: изготовления
наход: находятся
воспоминан: воспоминания
переста: перестают
жным: жными
секунд: секунд секунды
формирован: формирования
способн: способность
запомина: запоминать
форм: формы
вещ: вещей
говор: говорят
ошиба: ошибаться
явлен: явление
назва: назвали
иллюз: иллюзией
краткосрочн: краткосрочной
памят: памяти
перспектив: перспективе
памя: память
жно: жной
март: марте
отт: оттен
ведущ: ведущий
амстердамск: амстердамского
ожидан: ожидания ожиданиях
относительн: относительно
как: каким
долж: должен
начина: начинает начинаем
понемног: понемногу
исчеза: исчезать
полтор: полторы
заполня: заполнять
основыв: основываясь
предыдущ: предыдущие
показа: показали
предъявля: предъявляют
пов: пов
рнут: рнутую
зеркальн: зеркально
отраж: отраж
нну: нную
букв: букву
сообща: сообщают
ориентац: ориентации
тег: теги
хаб: хабы
голос: голосов
добав: добавить
закладк: закладки
комментар: комментарии
карм: карма
рейтинг: рейтинг
проповед: проповедую
храм: храме
наук: науки
задонат: задонатить
сайт: сайт сайта
вконтакт: вконтакте
сутк: сутки
похож: похожие
истор: истории
аккаунт: аккаунт
войт: войти
регистрац: регистрация
раздел: разделы
устройств: устройство
документ: документы
соглашен: соглашение
конфиденциальн: конфиденциальность
услуг: услуги
корпоративн: корпоративный
блог: блог
медийн: медийная
реклам: реклама
нативн: нативные
проект: проекты
образовательн: образовательные
программ: программы
стартап: стартапам
спецпроект: спецпроекты
яндекс: яндекс
дзен: дзен
настройк: настройка
язык: языка
техническ: техническая
поддержк: поддержка
вернут: вернуться
стар: старую
верс: версию
sly: sly
g: g
natur: nature
geoscienc: geoscience
free: free
radic: radical
biologi: biology
medicin: medicine
ser: sers
surfac: surface
enhanc: enhanced
raman: raman
spectroscopi: spectroscopy
microsoft: microsoft
micro: micro
soft: soft
twitter: twitter
m: a
materi: m
plo: materials
facebook: plos
vk: facebook
telegram: vk
youtub: telegram
habr: youtube
