хабр: хабр хабре
откр: открыть классификатора
список: список
стат: стать статьи статье статьях статья
автор: автором авторы сюда
поток: потоки поток
разработк: разработка
администрирован: администрирование
дизайн: дизайн
менеджмент: менеджмент
маркетинг: маркетинг
научпоп: научпоп
поиск: поиск поиску поиска обычным
профил: профиль
обнов: обновить
рейтинг: рейтинг рейтинга
компьютерн: компьютерный
анализ: анализ анализа
синтез: синтез
естествен: естественных естественного
язык: языков языка языке язык английским
компан: компании сайта
подряд: подряд
скопирова: скопировать
ссылк: ссылку
показыва: показывать показывают
нов: новые новую научилась
лучш: лучшие лучшее лучший лучшей авторов
порог: порог
уровен: уровень
сложност: сложности сложность
прост: простой простом простых простую поехали
средн: средний среднем
сложн: сложный сложно сложных решать
примен: применить русском
час: часов
начина: начинаем начинать надеюсь уровней
работ: работу работы работа работе
прочтен: прочтение
мин: мин
количеств: количество
просмотр: просмотров
машин: машинное машинного обучить
обучен: обучение обучения
искусствен: искусственный искусственные искусственным искусственных инструментов
интеллект: интеллект интеллектом искусственного
туториа: туториал
перевод: перевод перевода бесплатную
пост: посте пост
разбер: разберем
пример: примере
модел: модели моделей моделях модель моделью
классификац: классификации классификацию
текст: текста тексте тексты текст текстов
производительн: производительности
скорост: скорости
удобн: удобный
оста: остается
так: таким таки таких
динамическ: динамическим
ран: ранее
настройк: настройка
окружен: окружения
установк: установка
загрузк: загрузка
подготовк: подготовка подготовки
датасет: датасета
оценк: оценка
помощ: помощью
запуск: запуск запуска
инференс: инференса
тестирован: тестирование
чита: читать
дал: далее
голос: голосов
добав: добавить
закладк: закладки
комментар: комментарии заявлял
новост: новости
апр: апр
влия: влияем влиять
галлюцинац: галлюцинации галлюцинациями
потопа: потопаешь
полопа: полопаешь
будущ: будущее людям
песочниц: песочницы хабы
посмотр: посмотрим
называ: называемые
сут: сути
придумыван: придумывание
факт: фактов
нейрон: нейронной нейронные нейронных крупными
сет: сетью сети сетях сетей попросил нейронными
вран: врань
управлен: управление
позвол: позволит позволить позволившие граница
получа: получать метрики
хот: хотим хотите
крайн: крайней крайне
мер: мере
улучш: улучшит
вероятн: вероятность
получен: получения получением носителя
правдив: правдивого
ответ: ответа опубликовал
снижа: снижаем
размерн: размерность размерности
эмбеддинг: эмбеддингов
предложен: предложений предложенной
задач: задачи задач задача задачах задаче задачу
определен: определения
семантическ: семантического семантически
сходств: сходства
кейс: кейс
привет: привет
зовут: зовут
никола: николай
шука: шукан
участник: участник
профессиональн: профессионального начинающие
сообществ: сообщества
реч: речь никакой
пойдет: пойдет
метод: методах метод методов методы
снижен: снижения
кажд: каждым каждом причем
год: годом
растет: растет
реша: решающих помогать
вопрос: вопросы
контекстн: контекстно
ориентирова: ориентированной
обработк: обработки
забыва: забывать
проблем: проблемы проблема
мультиязычн: мультиязычности
сильн: сильно
сказыва: сказывается
увеличен: увеличении
размер: размеров
системн: системных
требован: требований
желез: железу
дообучен: дообучения
стоя: стояла
найт: найти
обобщ: обобщить
текстов: текстовые текстовой текстовых
дан: данные данными данный данных
представля: представляющие представляется обратно
масс: массив
точн: точно
знал: знал
сред: среди
схож: схожие
фраз: фразы фраз
прям: прямой
подход: подход
набор: наборов
требова: требовал
памят: памяти
реш: решить решили частично машинному
пробл: проблему
попыта: попытался
уменьш: уменьшить
вектор: векторов
признак: признаков
поня: понять
останов: остановиться остановить
даст: даст
узна: узнать
подробн: подробности
сдела: сделать коллегой
бот: бота ботах достаточно
сво: своими писать письменную
обзор: обзор
тем: тема
хайп: хайпе хайп
одн: одних одному одним
свет: свет
клин: клином
сош: сош
лся: лся
вс: вс
попробу: попробуем
разобра: разобраться
обойд: обойд
мся: мся
код: кода код
общ: общие
понят: понятия
бол: боль
страдан: страдание
истор: истории настоящую
мар: мар
уч: учим
английск: английский английского английском владения
изучен: изучение
пожал: пожалуй
языков: языковых последней
использован: использовании использованием
надоел: надоели
личн: лично
нашел: нашел
полезн: полезное полезную
применен: применение применения
изуча: изучать вообще
числ: числе
разговорн: разговорный
предлож: предложить создала
дел: деле
товарищ: товарищи
совмест: совместим
ассоциативн: ассоциативная
памя: память
нейросет: нейросетей новая
генерац: генерация генерации
алгоритм: алгоритмы алгоритм алгоритма алгоритме
ко: ко интерес
пришл: пришла
иде: идея
реализова: реализовать
основа: основанный основаны основан основанного основана
цепочк: цепочках цепочки
символ: символов символы
выделя: выделяет
последовательн: последовательностей последовательности последовательность последовательностью
образ: образом
производ: производит
похож: похож
построен: построения
грамн: грамной
разниц: разница разницу
стро: строит строить
перемен: переменной
длин: длины длинные
дела: делается делать
расскаж: расскажу сетями
результат: результате результат результата получены
сравнива: сравнивать
друг: друг другом
наход: находить котором
степен: степень
похожест: похожести
приспособ: приспособил
отсеива: отсеивать
известн: известные известного известной
выбира: выбирать
облада: обладают
наибольш: наибольшей
уникальн: уникальностью
момент: момент
посмотрет: посмотреть
вкратц: вкратце
ид: идеи
например: например
выдел: выделить
след: следующие следуют следующий
видн: видно
встреча: встречается встречаются лингвиста
раз: раза разу
случа: случае
разн: разные
ситуац: ситуация ситуацию
счита: считается души
конфликт: конфликтом конфликт конфликтов
необходим: необходимо
разреш: разрешить
созда: создаются создают вначале
трех: трех
поэт: поэтому
разрешен: разрешенным разрешения
неоднозначн: неоднозначностей
наблюда: наблюдается
разумеет: разумеется
обычн: обычном решила
написа: написанном развлекал попросили
человеческ: человеческом
потребова: потребоваться
постро: построить
горазд: гораздо
вспомн: вспомнил
попробова: попробовал
исследова: исследовать
поподробн: поподробнее
бизнес: бизнесу бизнесе
обраща: обращать
вниман: внимание внимания вашему
технолог: технологии
сто: стоят
мест: месте
вступ: вступили
эпох: эпоху
нача: начали началось
применя: применять применяться применяемые
некотор: некоторых слов
професс: профессий
чувствова: чувствовать
конкуренц: конкуренцию составлять
сторон: стороны
программн: программных чисто несложные
продукт: продуктов программный стартапа
происход: происходит
отрасл: отраслях
процесс: процесс
пошел: пошел
дума: думаю
вряд: вряд
удаст: удастся
крупн: крупные опыт
оптимизир: оптимизируют
расход: расходы
зарплат: зарплату
работник: работников
мал: малом
прогресс: прогресс прогресса
больш: большой большей больших большими большим
част: части часть
придержива: придерживаются
классическ: классических
основн: основную основном
выполня: выполняют
компьютер: компьютеры
использ: используются фреймворке использует
бухгалтер: бухгалтерии
учет: учета
выполнен: выполнения
зада: заданных
статическ: статическими
правил: правилами
операц: операций название
врод: вроде
слож: сложилась
предположен: предположения
счет: счет
возможн: возможно возможностей возможностях возможности
инерц: инерция
мышлен: мышления
заставля: заставляет
люд: людей каким
мысл: мыслить
шаблон: шаблонами
плох: плохо
хотел: хотел
человек: человека
смог: смог
заработа: заработать
миллион: миллион миллионы
доллар: долларов
работа: работает способ
миллиард: миллиарда
сталкива: сталкиваются
предел: пределом
переступ: переступить
состоян: состоянии
медлен: медленным
мнен: мнению мнение единого
рост: ростом
очевидн: очевидно
вол: волей
невол: неволей
приход: приходится приходит
меня: менять
подума: подумать
приобща: приобщаться
вершин: вершине
техническ: технического дзен
явля: являются зачастую
как: каков понимать
вход: входа
направлен: направлении направлений
реальн: реально разрабатывает
блог: блог
источник: источник
примечан: примечание
переводчик: переводчика
рассказыва: рассказывали прошлой
прочита: прочитать
занима: заниматься
культов: культовая
выпущен: выпущенная
развит: развитие стадии
чат: чат рабочих
оказа: оказалось оригинальных
важн: важной включая
русск: русский массива бесплатная
исправ: исправить
найд: найд
перв: первой первое троим вниманию
скор: скоро
выпуст: выпустим
продолжен: продолжение обсуждения
кратк: краткое
содержан: содержание
распростра: распростран
нны: нные
преобразован: преобразования
рекуррентн: рекуррентных рекуррентности
св: св
рточн: рточных
включа: включают операция
энкодер: энкодер
декодер: декодер
сам: самых самым
успешн: успешных успешно
соединя: соединяются
механизм: механизма механизмах
предлага: предлагают замечу
архитектур: архитектуру
трансформер: трансформер
исключительн: исключительно
рток: рток
эксперимент: эксперименты своем
показа: показали
качеств: качество
распараллеливан: распараллеливанию
меньш: меньшие
времен: временные эссе
затрат: затраты
достига: достигает
метрик: метрике подсчитав
немецк: немецкий
превосход: превосходит
предыдущ: предыдущий комментариях
пункт: пункта
французск: французский
достигл: достигла
наилучш: наилучшего
решен: решения решение
дне: дней
составля: составляет системы глаголов
небольш: небольшую рассмеяться
вычислительн: вычислительных
мощност: мощностей
затрач: затрачены
имеющ: имеющихся
публикац: публикаций
синтаксическ: синтаксический
разбор: разбор
весьм: весьма
ограничен: ограниченных
пайплайн: пайплайн
создан: создания создании создание
информац: информации песочница
программирован: программирование мемов
сезон: сезон
дарморез: дарморезов
вад: вадим
актуальн: актуальность
объем: объемами объемом
ещ: ещ
долг: долгое
неоспорим: неоспорима
спектр: спектр
вариатив: вариативен
именова: именованных
сущност: сущностей
кластеризац: кластеризации
обрабатыва: обрабатываемых
документ: документов компаний
представ: представим сеть
классифицирова: классифицировать
огромн: огромный
входя: входящих
обращен: обращений обращения
сотрудник: сотрудников сотрудниками
клиент: клиентов
дальн: дальнейшего
профильн: профильными
предмет: предмет мечтой
отклонен: отклонений
интерес: интересующих теряли надеемся
статистик: статистик
приходя: приходящее
голов: голову
ручн: ручном
режим: режиме
просматрива: просматривать
провод: проводить
спуст: спустя
пар: пару работал
осознан: осознание
правильн: правильным
выполн: выполнить
срок: срок
поступ: поступить
нейросетев: нейросетевого нейросетевые
моделирован: моделирования
сценар: сценариев сценария сценарий
атак: атаки атак атаку
информацион: информационная информационной
безопасн: безопасность безопасности черте
контент: контента
инс: инс
дн: дн
станов: становится
привычн: привычным
явлен: явлением
график: графику
видеоигр: видеоигр
пишут: пишут
книг: книги
дипломн: дипломные
синтезир: синтезируют
звук: звук
поддержива: поддерживают
диалог: диалоги
существен: существенный
вклад: вклад
популяризац: популяризацию
материал: материалов
несомнен: несомненно
вн: вн
отечествен: отечественных
аналог: аналогов
балабоб: балабобу
яндекс: яндекса спецпроекты
основ: основе
семейств: семейства
област: области
иб: иб
синтезирован: синтезирование
привлекательн: привлекательным
генерир: генерируют
сигнатурн: сигнатурные
баз: базы
вредоносн: вредоносный
фишингов: фишинговые
письм: письма
нагрузк: нагрузку
эксплойт: эксплойтов
инъекц: инъекций изобретение
перспективн: перспективных
написан: написание
нападен: нападения
красн: красной
команд: команды конференции
мног: многом покоя
напомина: напоминает
киносценар: киносценария
сюжет: сюжета
детектив: детектива
бумажн: бумажного
дом: дома
детективн: детективные
арсен: арсене
люпен: люпене
описан: описания
разлож: разложить
этап: этапы
соответств: соответствии получение полного
уязвим: уязвимости
описа: описать
техник: техники
тактик: тактики
процедур: процедуры
главн: главными
геро: героями
ошибок: ошибок
логик: логике
кот: котов
ил: илья
логическ: логических
робот: робота управлял
продемонстрир: продемонстрирую
тематическ: тематического
помогут: помогут
исследовател: исследователям
относ: относиться
серьезн: серьезно
рассказа: рассказано хочу
заостря: заострять
впечатля: впечатляют
подня: поднялся
настольк: настолько
хорош: хорош
захотел: захотели
пообща: ним
наскольк: пообщаться
крут: насколько
выход: крут
прошл: выхода поисковые соревнование
достаточн: прошло находится
продолжа: бот
привлека: продолжает
текущ: привлекать
верс: текущей старую
заменя: версии
способн: заменять дворника удивительные
вполн: способностей
хвата: вполне
теря: хватает
соглаш: кое
виртуальн: соглашусь претендует
собеседник: виртуальный
чист: собеседник
интернет: продукт
идет: интернете
никак: идет
управля: речи
наподоб: роботом
разрабатыва: наподобие
мир: реальном
систем: мире оценивать
рол: конкуренции
дворник: роль
убира: способного
улиц: убирать
претенд: улицу
сфер: виртуальной
однозначн: сфере
стад: однозначно
способ: развития рассмотрены словаря
создава: способен
несложн: создавать
ограничива: программного
придумыва: ограничиваются
интересн: придумывать
эсс: интересные
вписа: временем
ниш: вписаться
квалифицирова: нишу
интеллектуальн: квалифицированного
труд: интеллектуального
котор: труда
высокооплачива: достаточное
над: высокооплачиваемых
понима: начинаете
настоя: будущем
анекдот: история
рассмея: анекдотов
рассказ: небольшой
картинк: рассказ
проведен: картинками
массив: проведении
библиотек: применены
рассмотр: библиотеки вариант
векторизац: способы
токен: векторизации
получ: токенов важным
обсужден: результаты
велк: продолжения
удал: велком
наш: удалил помогал
пользовател: нашего захвата
объяснен: пользователей
причин: объяснения
стартап: причин программы
недел: продуктом
коллег: недель моих русскоговорящим
помога: сделали служить
рабоч: наших
развлека: чатах
потряса: написан
фреймворк: потрясающем
оригинальн: используется чтения
попрос: оригинальном ответ
план: написать придумала
захват: план
твиттер: пользователь
опубликова: твиттер
зло: представить
ген: злой
разработа: гений
схем: разработать
перехитр: схему
илон: перехитрить
маск: илон
подошл: маска
основательн: подошла
придума: основательно
назван: плану одинаковым
фаз: включает
науч: фазы
жутковат: нейросеть
удивительн: жутковато
последн: способности
пониман: языковой
мем: понимания
покопа: программирования
капот: покопаемся
подошел: капотом
черт: подошел
поеха: безопасного
полнотекстов: простейший
поддержк: полнотекстовый техническая
морфолог: поддержкой
поисков: морфологии
состав: рассказывала
проект: составила нативные
словар: проекта моего
властелин: словарь
колец: властелина
прич: колец
англоязычн: каждого
терм: англоязычного вхождения
слов: терма отдельных
словосочетан: слова
хран: словосочетания
глав: хранится
выражен: глав многословных
составл: выражение
вручн: составлено
дает: вручную
поко: дает
вхожден: многие
могл: термов
пропущ: могли
частичн: пропущены
подстрок: поиском фактически
границ: подстроке
отдельн: позволило
внешн: некоторыми
флекс: внешними
фактическ: флексиями
джокер: подстроки
конц: джокером
многословн: конце
неправильн: выражений
глагол: неправильных
весом: составляющих
дол: весомую
мо: долю большинство
безуспешн: пары
попыток: безуспешных
установ: попыток
типичн: установить
изобретател: типичный
велосипед: изобретатель
вечн: велосипеда
двигател: вечного
писа: двигателя переводу
изобретен: свой
синдром: инъекция
выучен: синдрома
беспомощн: выученной
промт: беспомощности
выигра: промтами
соревнован: выиграть использовали
насыщ: прошлый
релиз: насыщен
мощн: релизами
инструмент: мощных
включ: интеллекта
оп: получить
использова: расскажем
конференц: соревновании
запрос: команд
вер: запросов
должн: верим
служ: должны
наде: сложные
полез: интересен
бинарн: полезен
классификатор: бинарного
ящик: открыло
пандор: ящик
стандарт: пандоры
владен: стандартах языком идентичного
принят: владение
оценива: принято
состоя: системе
шест: состоящей
уровн: шести соответствия уровня считают
владеющ: профессионально
иностра: владеющие
международн: иностранным
позиционир: международный
образова: позиционируется
носител: образованного определить
сертификат: соответствующего
зачаст: сертификата
либ: является
заветн: либо
мечт: заветной
гордост: предметом
преподавател: гордости коллег
лингвист: преподавателя
научн: встречала
литератур: научной
доказательств: литературе
полн: доказательства
родн: уровню
учен: родным
един: ученых
вообщ: мнения
достич: изучающим
идентичн: достичь
практическ: владению
одинаков: практически
противоположн: названием
вывод: противоположными
провед: выводами
опрос: проведя
соцсет: опрос
увидел: соцсетей
большинств: увидела
глубин: преподавателей
душ: глубине
бездн: уровнем
выбра: бездна
вариант: выбрал
аспект: рассмотрев
письмен: аспект
обошл: эксперименте
хоч: обошлось
вначал: рассказать
русскоговоря: предложила
челлендж: коллегам
определ: челлендж
британц: носителем коренным
русскоязычн: британцем
исследован: русскоязычным
приглаша: исследованию
эксперт: приглашались
опыт: эксперты
проверк: опытом
студенческ: проверки
чтен: студенческих
подсчита: оказалась
замеч: получаем
корен: предлагала
тро: британцам
бесплатн: первая первую
китайск: русского решил
обратн: китайский
ваш: представляю
легк: писал
обуч: легко
заявля: китайского
сюд: предыдущей
аккаунт: лучших
войт: аккаунт
регистрац: войти
раздел: регистрация
хаб: разделы
устройств: информация
сайт: устройство
соглашен: документы
конфиденциальн: соглашение
услуг: конфиденциальность
корпоративн: услуги
медийн: корпоративный
реклам: медийная
нативн: реклама
образовательн: проекты
программ: образовательные
спецпроект: стартапам
дзен: яндекс
вернут: поддержка
стар: вернуться
natur: natural
languag: language
process: processing
rss: rss
nastaa: nastaa
pytorch: pytorch
hug: hugging
face: face
transform: transformers transformer
python: python
fine: fine
tune: tune
bert: bert
trainer: trainer
lefttoddl: lefttoddler
chatgpt: chatgpt
newtechaudit: newtechaudit
data: data
scientist: scientist
nta: nta
nlp: nlp
mv: mvs
amazon: amazon
lex: lex
gpt: gpt
big: big
openai: openai
alexbryl: alexbryl
turbo: turbo
whisper: whisper
telegram: telegram
luksian: luksian
mine: mining
n: n
http: http
ru: ru
abcabd: abcabd
ab: ab
bc: bc
ca: ca
bd: bd
abc: abc
abd: abd
word: word words
excel: excel
vd: vds
ruvd: ruvds
attent: attention
bleu: bleu
wmt: wmt
gpu: gpu
machin: machine
learn: learning
payusova: payusova
red: red
team: team
yalm: yalm
rugpt: rugpt
xl: xl
sber: sber
gener: generative
pretrain: pretrained
deepfak: deepfake
sql: sql
kill: kill
chain: chain
tf: tf
idf: idf
dbscan: dbscan
engin: engineering
boston: boston
dynam: dynamics
vlesinskij: vlesinskij
otu: otus
gensim: gensim
sklearn: sklearn
bag: bag
maxpain: maxpain
api: api
googl: google
cloud: cloud
platform: platform
proxi: proxy
typescript: typescript
grammi: grammy
open: open
ai: ai
mypanacea: mypanacea
twitter: twitter
chatgtp: chatgtp
tweetstorm: tweetstorm
stalkermustang: stalkermustang
scienc: science
ioanna: ioanna
mvp: mvp
b: b
term: term
s: s
ed: ed
ing: ing
elasticsearch: elasticsearch
panda: pandas
tviskaron: tviskaron
neurip: neurips
iglu: iglu
airi: airi
stabl: stable
diffus: diffusion
dall: dalle
interact: interactive
ground: grounded
understand: understanding
neurp: neurps
jayatsea: jayatsea
cerf: cerf
common: common
european: european
refer: reference
framework: framework
form: a
accuraci: forms
precis: accuracy
recal: precision
f: recall
utrobinmv: f
offlin: utrobinmv
snaker: offline
averkij: snakers
rg: averkij
softwar: rg
cointegr: software
irokez: cointegrated
aliaksei: irokez
rudak: aliaksei
rybolo: rudak
takagi: rybolos
tyomitch: takagi
facebook: tyomitch
vk: facebook
youtub: vk
habr: youtube
