хабр: хабр хабре
откр: открыть
список: список
стат: стать статьи статье статью статей статья
автор: автором авторы авторов автор
поток: потоки потока поток потоке
разработк: разработка
администрирован: администрирование
дизайн: дизайн
менеджмент: менеджмент
маркетинг: маркетинг
научпоп: научпоп
поиск: поиск
профил: профиль
обнов: обновить
новост: новости новостей новостям новость
хаб: хабы
компан: компании сайта
подряд: подряд
скопирова: скопировать
ссылк: ссылку
показыва: показывать показывают
нов: новые новых новый новому выстраивается
лучш: лучшие
порог: порог
рейтинг: рейтинга рейтинг
уровен: уровень
сложност: сложности сложностей
прост: простой
средн: средний
сложн: сложный сложного
примен: применить
минут: минуту минуты
систем: система
кругов: кругового
обзор: обзора обзор
видеокамер: видеокамерой
враща: вращающимися
зеркал: зеркалами
прочтен: прочтение
мин: мин
количеств: количество количества
просмотр: просмотров
автомобильн: автомобильные
гаджет: гаджеты гаджетом
высок: высокая высокое высоких
производительн: производительность производительности
занимательн: занимательные
задачк: задачки
работ: работа работу работы менеджерам
виде: видео
фототехник: фототехника
песочниц: песочницы песочницу разделы
пиш: пишу
тип: типа тип
критик: критикуйте
физик: физику физика
математик: математику
изуча: изучал
ид: идеи
кажут: кажутся
перспективн: перспективными
став: ставят ставя
камер: камер
периметр: периметру
охраня: охраняемой
территор: территории
рыб: рыбий
глаз: глаз глаза
бампер: бампер
авт: авто
неприятн: неприятными неприятных
искажен: искажениями
сторон: стороны
глядет: глядеть
напас: напас
шься: шься
широконаправлен: широконаправленные
качествен: качественные
середин: середины
объект: объекта объекты
сверх: сверху
обозрет: обозреть
принцип: принципе принцип
вс: вс
полн: полную достичь
сфер: сферу
исключ: исключая
корпус: корпус
гц: гц
небольш: небольшим
зеркальн: зеркальный
датчик: датчик внедрения
зд: зд
подсказа: подсказать
сам: самые самых самый
интересн: интересные интересна
опасн: опасные опасность опасности опасна
помощ: помощью помощи
нейросет: нейросетей нейросети
определ: определить определены
расстоян: расстояние расстоянии
люб: любого любой
габарит: габариты
вычисл: вычислить
скорост: скорость скорости
направлен: направление
текущ: текущую текущей
шник: шников
найд: найд вопросы
тся: тся
выгляд: выглядит
чита: читать читали
дал: далее
добав: добавить
закладк: закладки
комментар: комментарии
час: час часов
проблематик: проблематика
концепц: концепции
миров: мировой
сетев: сетевой
инфраструктур: инфраструктуры
решен: решение гарнитуры
децентрализова: децентрализованного
детерминизм: детерминизма
читальн: читальный
зал: зал
истор: история истории
криптовалют: криптовалюты
репортаж: репортаж
привет: привет
уважа: уважаемые
хабровц: хабровцы
наболевш: наболевшем
понима: понимаю
информац: информация информации информацию
разрознен: разрозненной
постара: постарался
рассказа: рассказать
основн: основную основным основного
понят: понятиям понятие
част: часть
понятн: понятна
мастодонт: мастодонтам
област: области
ознакомительн: ознакомительна
дума: думаю думает
мног: многим многих многие
над: надеюсь
весьм: весьма
откладыва: откладывать
вопрос: вопрос ответы
долг: долгий
ящик: ящик
приступ: приступим
приступа: приступать
голос: голосов
дайджест: дайджест
недел: неделю недели
писа: писали
научн: научно
популярн: популярное популярную популярной
здравств: здравствуйте
вячесла: вячеслав
голован: голованов
курир: курирую
сред: среди окружающей
мо: моих моей
задач: задач
увеличен: увеличение
публикац: публикаций
числ: числе
привлечен: привлечение
хорош: хороших хорошему хорошего хороший
хотел: хотели
написа: написать
тем: тему теме тема
боя: боялись
нача: начать начало
знак: знак
может: можете
обсуд: обсудить
личн: личные
сообщен: сообщения
кинут: кинуть
пройд: пройдусь
уходя: уходящей
наш: нашей наших нашими нашем
редакц: редакции
сто: стоило стоит
освет: осветить
подробн: подробнее
получ: получилось получим
суперспособн: суперспособностей
хим: химия
разъеда: разъедающая
озонов: озоновый озоновой
сло: слой
непонятн: непонятным
образ: образом образ
возвраща: возвращается
атмосфер: атмосферу
несмотр: несмотря
запрет: запрет
снимк: снимке
сдела: сделанном сделай сделать
сентябр: сентябре
площад: площадь
антарктическ: антарктической
дыр: дыры
составля: составляет
млн: млн
км: км
начина: начинаем
машин: машинное машин
обучен: обучение
искусствен: искусственный искусственного
интеллект: интеллект интеллекта
туториа: туториал
перевод: перевод
пост: посте
разбер: разберем
пример: примере
модел: модели моделью модель
классификац: классификации
текст: текста
удобн: удобный
оста: остается
так: таким
динамическ: динамическим
ран: ранее
настройк: настройка
окружен: окружения
установк: установка
загрузк: загрузка
подготовк: подготовка
датасет: датасета
оценк: оценка
запуск: запуск
инференс: инференса
тестирован: тестирование
ликвидн: ликвидный ликвидного ликвидность ликвидном
стейкинг: стейкинг стейкинга стейкинге
технолог: технологии технология технологиям
увелич: увеличит
капитализац: капитализацию
раз: разы
финанс: финансы
преддвер: преддверии
обновлен: обновления
изуч: изучили
ончейн: ончейн
показател: показатели
проект: проектов проекте проект нативные
развива: развивающих развиваться
экосист: экосистему
собра: собрали
план: планах передний
развит: развития развитию
разобра: разобрали
описа: описали
позволя: позволяют
сильн: сильно
масштабирова: масштабировать
эфириум: эфириум эфириума
перспектив: перспективе
подготов: подготовили
сер: серию
будущ: будущем будущее будущие
перв: первая первого
дериватив: деривативов
материал: материале множество проводящие
заключа: заключается
счита: считается считалась считать
прорыв: прорывом
блокчейн: блокчейн
пространств: пространства
заработа: заработать
тренд: тренде тренд
порассужда: порассуждаем
явля: является
явн: явным
нарратив: нарративом
крипт: крипте
поеха: поехали
содержан: содержание
обернут: обернутые
ток: токены
провайдер: провайдеры
полож: положить положен
эфир: эфир
преимуществ: преимущества
увеличива: увеличивает
монет: монет
риск: риски риск
централизац: централизация
регуляц: регуляция
вывод: выводы
электронщик: электронщиков
нюанс: нюансы
использован: использования
блог: блог
интерфейс: интерфейсы
производств: производство
электроник: электроники
компьютерн: компьютерное сегмент
желез: железо
итак: итак
предыдущ: предыдущие предыдущей
основ: основы основу служит
знаком: знакомы
возможн: возможно возможности возможных
нек: некая
задумк: задумка
применен: применению применения
стандарт: стандарта
сво: сво свой
желан: желание
снаряд: снарядить
одноплатник: одноплатник
нескольк: несколькими
деш: деш
вым: выми
мощн: мощными
карт: картами
вардрайвинг: вардрайвинга
добавлен: добавление
втор: второго второе
ноутбук: ноутбук
вмест: вместо
неиспользуем: неиспользуемого
контроллер: контроллера
подключен: подключение
полноразмерн: полноразмерной
видеокарт: видеокарты
наворочен: навороченный
переходник: переходник
собира: собирались
реализова: реализовать
дава: давайте
убед: убедимся
звуч: звучит
растен: растения растений
плачут: плачут
копирайт: копирайт
биолог: биология
учен: ученые инженерии докладе
записа: записали
хлопа: хлопающие
звук: звуки звука
изда: издают
ответ: ответ ответить созданные
стресс: стрессы стресса
обезвоживан: обезвоживание
порез: порез
люд: людей
великолепн: великолепные
способ: способы
выраз: выразить
недовольств: недовольство
ворч: ворчим
сету: сетуем
оха: охаем
стена: стенаем
подума: подумать
подач: подачи
жалоб: жалоб
треб: требуется
крайн: крайней
мер: мере
рот: рот
недавн: недавние тени
исследован: исследования основой
царств: царстве
обязательн: обязательным
находя: находящиеся
состоян: состоянии состояния
слышим: слышимые
услыша: услышать услышанный
фут: футов
соответств: соответствует
плох: плохой
результат: результаты
опубликова: опубликованы
четверг: четверг
журнал: журнале
хакер: хакеры
удален: удаленно распространением
взламыва: взламывать
умн: умные умный умных умным
гараж: гаражи гаражей
мир: миру мире мир
информацион: информационная
безопасн: безопасность безопасности безопасно
облачн: облачные
сервис: сервисы
дом: дом
исследовател: исследователь исследователя
обнаруж: обнаружил
ряд: ряд
уязвим: уязвимостей
открывател: открывателях
марк: марки
наход: находить
нужн: нужные нужную
момент: момент
открыва: открывать
интернет: интернет
ещ: ещ
и: ии
побед: победит
вдовол: вдоволь
нарис: нарисуется
безграничн: безграничные
говор: говорят
суз: сузили
угол: угол
рассмотрен: рассмотрения
глобальн: глобального
явлен: явления
инструмент: инструментов
созда: создающих создают удалось умели
запрос: запросу
изображен: изображения изображений
попрос: попросили
эксперт: экспертов
ит: ит
гигант: гигантам
дел: делимся дела
мнен: мнениями изменилось
кат: катом
письм: письмо
котор: которое
смог: смогу
отправ: отправить
прошл: прошлое прошлого
смотр: смотри
сед: седой
морщин: морщинами
влез: влезу
коричнев: коричневый
костюм: костюм
ноч: ночь
верста: верстал
студенческ: студенческую
газет: газету
каз: каз
нном: нном
ровер: ровере
крякнут: крякнутом
паблишер: паблишере
пространствен: пространственно
времен: временной
континуум: континуум
искрив: искривится
лент: ленту
прочт: прочт
шь: шь
смож: сможем
измен: изменить изменит решения
ладн: ладно
дурак: дурак
зна: знаю знаем
обраща: обращаюсь
летн: летнему
поговор: поговорить
честн: честно
половин: половина
пут: пути
хвата: хватает
кодинг: кодинг
непрограммист: непрограммиста
продвинут: продвинуться продвинутые
хочет: хочется
твор: творить
создава: создавать
полезн: полезное
коллег: коллеги
утвержда: утверждают
активн: активных активно активные
проб: проб пробует
ошибок: ошибок
путн: путного
клавиатур: клавиатуры
выйдет: выйдет
сможет: сможет
интерв: интервью
критическ: критическом критическому
мышлен: мышлении мышлению
ил: илья
живет: живет
авторитарн: авторитарном
государств: государстве
обуча: обучать
сем: семью
подверг: подвергая
неблагоприятн: неблагоприятное
социальн: социальное
положен: положение
осмотрительн: осмотрительно
стратег: стратегий
детал: деталях
гонк: гонка
вышл: вышла
контрол: контроля
настольк: настолько
манхэттенск: манхэттенский
обработк: обработка блоков
подобн: подобно подобных
создан: созданию метод
атомн: атомной
бомб: бомбы
проблем: проблема
оригина: оригинала
главн: главные главным
релиз: релизы
игров: игровой игровые
выставк: выставки выставка
сбер: сбер
продвижен: продвижение
игр: игр игры
консол: консоли
отмен: отменили
заточк: заточка
ребр: ребро
геймер: геймера
миллениа: миллениала
год: годам годов
жизн: жизни
интерес: интересы
конц: конце
десятилет: десятилетия
событ: событием
индустр: индустрии
крупн: крупнейшие
ежегодн: ежегодно
оплачива: оплачивали
бо: бо
льшу: льшую
праздник: праздника
пересмотрел: пересмотрели
приоритет: приоритеты
новинк: новинки
самостоятельн: самостоятельно
увидел: увидели
одн: одну одним
онлайн: онлайне
вряд: вряд
верн: верн верно
геймерск: геймерский
повод: повод
вспомн: вспомнить
прошедш: прошедших
выставок: выставок
удивительн: удивительные
клеточн: клеточные
автомат: автоматы
блочн: блочные блочных
ка: ка
окрестн: окрестность окрестностью окрестностей
марголус: марголуса
программирован: программирование
алгоритм: алгоритмы
отойд: отойд
классическ: классической
стро: строить
конфигурац: конфигурацию конфигурация конфигурации
благ: благо
никак: никаких
сегодняшн: сегодняшняя
предполага: предполагает
сетк: сетка сетки
разбива: разбивается
некотор: некоторые
участк: участки
собствен: собственно
блок: блоки блоку отсутствие
заран: заранее
инструкц: инструкции
переход: перехода
вариац: вариаций
шаблон: шаблон шаблона
расположен: расположения
набор: набор
бессвязн: бессвязных
осциллятор: осцилляторов
услов: условие
шаг: шаг
происход: происходит
смещен: смещение смещением
разбиен: разбиения разбиение
сч: сч
клетк: клетки клетку клетке
кажд: каждой каждого каждому
след: следующей следите
итерац: итерации итерацию
относ: относятся
построен: построения
диагона: диагонали
дан: данная метода
нос: носит
пионер: пионера
изучен: изучения
норма: нормана
вид: вид
называ: называют
отлича: отличается
логическ: логически
обозрева: обозревали
отобража: отображает
сраз: сразу
привяза: привязана
конкретн: конкретной
магнитокумулятивн: магнитокумулятивные
генератор: генераторы генераторов
источник: источники источником
сверхсильн: сверхсильных
магнитн: магнитных магнитной магнитного
пол: полей
импульсн: импульсного импульсные
питан: питания питанием
х: х
век: века
взрывомагнитн: взрывомагнитных
представля: представляющих
кумуляц: кумуляции
сжат: сжатия
освеща: освещалась
обзорн: обзорно
глубж: глубже
погружа: погружает
аппарат: аппарат
гамильтон: гамильтона
дыхан: дыхание
биотехнолог: биотехнологии
здоров: здоровье
вещ: вещи вещей
задумыва: задумываемся
удар: ударить
сердц: сердце
течен: течение
никт: никто
умеет: умеет
осозна: осознанно
контролирова: контролировать
напряжен: напряжение
сосудист: сосудистой
стенк: стенки
н: н
основа: основана
механик: механика
поддержан: поддержания
кровян: кровяного
давлен: давления
низк: низкое
кров: кровь
снабжа: снабжать
орга: органы
кислород: кислородом
вынос: выносить
отход: отходы
появля: появляется
всяк: всяких
врод: вроде
поражен: поражений
сетчатк: сетчатки
разрыв: разрывов
сосуд: сосудов
проч: прочих секретарям
патолог: патологий
пыта: пытаться
выбира: выбирать
акц: акции
портфел: портфель
способн: способны
профессиональн: профессиональные рынке
управля: управляющие
инвестиц: инвестиции
важн: важного
инвестицион: инвестиционные инвестиционными
менеджер: менеджеры центров
имеющ: имеющие
куч: кучу
диплом: дипломов
располага: располагающиеся
этаж: этажах
крут: крутых
небоскр: небоскр
бов: бов
аналитик: аналитики
статист: статисты
месяц: месяцами
высчитыва: высчитывают
денежн: денежные
специалист: специалисты
пишут: пишут
программ: программы
анализ: анализа
новостн: новостной
строчк: строчки
отч: отч
применя: применяют
нейрон: нейронные
сет: сети
объедин: объединить
слоган: слоганом
заслужива: заслуживают
всеобщ: всеобщего
восхищен: восхищения
роскошн: роскошных
шикарн: шикарных
яхт: яхт
спасательн: спасательный
круг: круг
клиент: клиентов корпоративные работе
передава: передавать
капита: капитал
умел: умелые данного
рук: руки
сравн: сравним
успех: успехи
пассивн: пассивными
аналог: аналогами
доступн: доступными
мухоловк: мухоловка
тарака: таракан
колесниц: колесница
робот: роботы автономных
ориг: оригами
микрочип: микрочипов
робототехник: робототехники
окружа: окружающий взаимодействовать
вдохновен: вдохновения вдохновении
творческ: творческого
человек: человека
художник: художники
вдохновля: вдохновляются
невообразим: невообразимой
красот: красотой
закатн: закатного
неб: неба
писател: писателей
наталкива: наталкивает
рома: роман
вскольз: вскользь
разговор: разговор
метр: метро
ко: коих
принят: принято
прагматик: прагматиками
практик: практиками
нужда: нуждаются
прийт: прийти
неожида: ним
мест: неожиданных
складыван: мест
лист: складывание
бумаг: листа
определен: бумаги
получен: определенным
фигурк: получения
служ: фигурки
инженер: исследований
уда: ученым
множеств: создать
конституц: материалов
взаимодействова: конституций
достич: средой
цикл: полного
восприят: цикла могли датчиков
действ: восприятие восприятием вычисления
удава: действие
причин: удавалось
неудач: причиной
отсутств: неудачи
могл: обработки
калифорнийск: действием
университет: калифорнийского
лос: университета
анджелес: лос
сша: анджелес
разработа: сша
метод: разработали особенность
автономн: создания
баз: роботов
посредств: базе
внедрен: посредством
вычислен: восприятия
проводя: действия
особен: материалы
доклад: найдем
телефон: ученых
гарнитур: телефонные профессиональных
сегмент: мнение
перифер: компьютерной
пережива: периферии
процесс: переживает
российск: процессы
рынок: российский
тен: рынок
лидер: недавних
постепен: лидеров
выход: постепенно
передн: выходит
выстраива: план
структур: новую
продукц: структуру
остальн: продукция
поставщик: остальных
потребител: поставщиков
приход: потребителям
иска: приходится
привычн: искать
предложен: привычные
тестирова: предложения
стал: тестировать
исключен: стали
оборудован: исключением
традицион: оборудование
приобрета: традиционно
корпоративн: приобретают услуги
покупа: клиенты
сотрудник: покупают
контакт: сотрудников
колл: контакт
центр: колл
секретар: клиентами
работник: прочим
распространен: работникам
гибридн: удаленного
график: гибридного
использ: графиков
бизнес: используют
класс: бизнес
домашн: класса
офис: домашнем
каков: офисе
ситуац: какова
рынк: ситуация
сюд: гарнитур
аккаунт: сюда
войт: аккаунт
регистрац: войти
раздел: регистрация
устройств: песочница
сайт: устройство
документ: компаний
соглашен: документы
конфиденциальн: соглашение
услуг: конфиденциальность
медийн: корпоративный
реклам: медийная
нативн: реклама
образовательн: проекты
стартап: образовательные
спецпроект: стартапам
яндекс: спецпроекты
дзен: яндекс
язык: дзен
техническ: языка
поддержк: техническая
вернут: поддержка
стар: вернуться
верс: старую
rss: rss
witf: witfed
rfc: rfc
valerylinkov: valerylinkov
webassembl: webassembly
web: web
sly: sly
g: g
nastaa: nastaa
pytorch: pytorch
hug: hugging
face: face
transform: transformers
python: python
natur: natural
languag: language
process: processing
fine: fine
tune: tune
bert: bert
trainer: trainer
mediametriqa: mediametriqa
lsd: lsd
ethereum: ethereum
shanghai: shanghai
eth: eth
liquid: liquid
stake: staking
deriv: derivatives
weth: weth
steth: steth
yeth: yeth
bright: bright
translat: translate
pcie: pcie
ruvd: ruvds
dii: diy
wifi: wifi
ssd: ssd
nvme: nvme
ethernet: ethernet
raspberri: raspberry
pi: pi
wavebreak: wavebreaker
cell: cell
virtual: virtual
explor: explorer
firstvd: firstvds
nexx: nexx
ib: ibs
habrablog: habrablog
dragomalkin: dragomalkin
ava: ava
chatgpt: chatgpt
world: world
ikamensh: ikamensh
deemchan: deemchan
dan: dan
snow: snow
hanamim: hanamime
electron: electronic
entertain: entertainment
expo: expo
e: e
tlhe: tlhe
timeweb: timeweb
cloud: cloud
sea: sea
xx: xx
inbioreactor: inbioreactor
quantumcross: quantumcross
dmytro: dmytro
kikot: kikot
ua: ua
host: hosting
compani: company
sens: sense
decid: decide
act: act
lexu: lexus
facebook: facebook
twitter: twitter
vk: vk
telegram: telegram
youtub: youtube
habr: habr
