хабр: хабр
откр: открыть
список: список
стат: стать статье статей статью статьи
автор: автором автор хабы устройство
поток: потоки
разработк: разработка
администрирован: администрирование
дизайн: дизайн
менеджмент: менеджмент
маркетинг: маркетинг
научпоп: научпоп
поиск: поиск
профил: профиль
обнов: обновить
оценк: оценка
компан: компании авторов
карьер: карьере карьера
рейтинг: рейтинг
обеспечива: обеспечиваем обеспечивает
стабильн: стабильную
работ: работу работы работе
проект: проектов проект нативные
блог: блог
новост: новости
ваканс: вакансии
подписчик: подписчики
ещ: ещ
сотрудник: сотрудники
нов: новые новой новыми нового новая
скопирова: скопировать
ссылк: ссылку
показыва: показывать
лучш: лучшие лучшее
примен: применить
час: часов
мир: мир миров
приключен: приключений приключения
сервер: серверу сервера сервер
част: часть
наблюден: наблюдение
кэширован: кэширование
прочтен: прочтение
мин: мин
количеств: количество количества
просмотр: просмотров
инфраструктур: инфраструктура средств
перевод: перевод
наш: нашей наших нашего
предыдущ: предыдущей
рассмотрел: рассмотрели
интерфейс: интерфейс
хранилищ: хранилища
исследова: исследовали
единствен: единственную единственная
реализац: реализацию реализация реализацией
дерев: дереве
внимательн: внимательное
сносок: сносок
пост: посте постов
показа: показало
честн: честными честно
говор: говоря говорим
оспор: оспорить
техническ: технической языка
треб: требуется
базов: базовая базовых базовые
подробн: подробно
рассмотр: рассмотрим
одн: одном одно
будущ: будущих
изуч: изучим изучить
возможн: возможности возможно пользователей
чита: читать
дал: далее дал
голос: голосов
добав: добавить
закладк: закладки
комментар: комментарии
уникальн: уникальные уникальность
индекс: индексы индекса
таблиц: таблиц таблицах таблицами
баз: баз базы
дан: данных доступной
распредел: распредел
нны: нные
систем: системы системой системах системе
аналитик: аналитика
ограничен: ограничения ограниченным ограниченной ограничение
классическ: классическая
функц: функция функций
реляцион: реляционной
столбц: столбца столбцов
групп: группы
ввод: ввода
построен: построения
указа: указаны указать
помощ: помощью помощи
ключев: ключевых
слов: слов
сущност: сущности
поддержива: поддерживают поддерживались
разбер: разбер
помога: помогают помогает
принима: принимать
эффективн: эффективные эффективной
решен: решения решение решением
планирован: планированию
пример: примеры примеру примере пример
сценар: сценариев
объясн: объясним
обрабатыва: обрабатываются
апр: апр
добр: добро
пожалова: пожаловать
индустр: индустрии
состо: состоит
нескольк: нескольких
компонент: компонентов компонентами
значительн: значительная
взаимодейств: взаимодействий взаимодействуют взаимодействия
итогов: итогового
пользовател: пользователя пользователи действий
осуществля: осуществляется
представля: представляет
отправн: отправную
точк: точку
мног: многих
созда: создал
существован: существования
расшир: расширен
поддержан: поддержания
дополнительн: дополнительной дополнительные
произвольн: произвольной
функциональн: функциональности
поэт: поэтому
оказыва: оказывается
мест: местом
котор: которое которую
изначальн: изначально
задума: задумано
размещен: размещения
крайн: крайней
мер: мере
хорош: хорошего
сер: серии
погруз: погрузимся
дета: детали
получ: получим получить
представлен: представление
работа: работают работает
как: какими
параллельн: параллельно
поэкспериментиру: поэкспериментируем
замен: заменой
пользовательск: пользовательских пользовательскими
создад: создадим
инструментар: инструментарий
модифицирова: модифицировали
соответств: соответствии
кейс: кейсами кейсы
знает: знает
постро: построим
собствен: собственный собственные
принцип: принципы принципами
процесс: процессы
предсказыва: предсказывать
системн: системные системное системный системным
бо: бои
станов: становится
вс: вс
сложн: сложнее сложных сложной
предотврат: предотвратить
остановк: остановки
крупн: крупные
мал: малые
обрат: обратились
качеств: качестве
позволя: позволяет
прогнозирова: прогнозировать
выявля: выявлять
потенциальн: потенциальные
сбо: сбои
намерен: намеренно
вно: внося
неисправн: неисправности
сист: систему систем
так: таким таких таком
образ: образом
наход: находить
устраня: устранять
преврат: превратятся
просто: простои
растущ: растущая
тенденц: тенденция
команд: команд командами командах команде
новичок: новичок
пришл: пришли
верн: верному
адрес: адресу адрес адресов
познаком: познакомим
покаж: покажем
нача: начать начало
партицирован: партицирование партицирования
рекурс: рекурсия рекурсии
наследован: наследование наследования
обзор: обзор
важн: важно
понима: понимать
поведен: поведение
правильн: правильную контролировать современное
парадигм: парадигму парадигмы
разбира: разбираемся
изменен: изменениями
легас: легаси
мар: мар
собира: собирать
лог: логи логов
туториа: туториал
логирован: логирование
трех: трех
столп: столпов
мониторинг: мониторинга
распределен: распределенных распределенные
мож: можем
видет: видеть
бурн: бурное
развит: развитие
популярн: популярных
продукт: продуктов продукта
открыт: открытым
исходн: исходным
код: кодом код
тип: типа
полноцен: полноценных
коммерческ: коммерческих
проблем: проблемами проблемой
протоколирован: протоколирования протоколирование
больш: больших большего
масштаб: масштабах масштабе
оста: остается
усугубля: усугубляется
постоя: постоянным
рост: ростом
объем: объема
внедрен: внедрения
контейнеризац: контейнеризации
различн: различные
вид: виды
необходим: необходимых
улучшен: улучшения
удел: уделим
вниман: внимание
подход: подходам подходы подходов
сбор: сбору сбор
агрегац: агрегации
анализ: анализу
привед: приведем
использован: использованием использования использовании
сервис: сервисов
упрост: упростит
перв: первая
верс: версия старую
субд: субд
совместим: совместимая
секционирова: секционированными
небольш: небольшая
предыстор: предыстория
выполня: выполнялось
форм: форме
сут: сути
вариант: вариантом
начин: начиная
использова: использовать
декларативн: декларативный
синтаксис: синтаксис
определен: определения придерживались
раздел: разделов регистрация
рамк: рамках выход
слиян: слияния
вобра: вобрал
разбиен: разбиения
сохран: сохранив
результат: результате
шанс: шанс
взят: взять
обо: обоих
обсуд: обсудим
совет: совета
рекомендац: рекомендации
оригина: оригинала
иоаннис: иоаннис
мустакис: мустакис
используем: используемых
программн: программных программного
инструмент: инструментов инструменты инструменте подходящим
управлен: управления
конфигурац: конфигурацией
предоставлен: предоставления
обеспечен: обеспечения обеспечением
развертыван: развертывания
приложен: приложений приложения
облачн: облачных облачной
локальн: локальных
сред: средах
подел: поделимся поделился
настройк: настройке настроить
предлож: предложим
интересн: интересные вероятно
внутрен: внутренними внутренние
сетев: сетевые сетевая сетевыми
политик: политики политиками политика движок
изоляц: изоляции изоляция
под: подов поды подами
пространств: пространств пространства
н: н
изолирова: изолировать
помогут: помогут
модел: модели модель
определя: определяет определяется политик
получа: получает
взаимодействова: взаимодействовать
люб: любыми любим
друг: другими друг другом
кластер: кластере задумывались
дава: давайте
разверн: разверн
потестиру: потестируем
высок: высокая высокими высокой
производительн: производительность производительности
узкоспециализирова: узкоспециализированные
вещ: вещи
полезн: полезны
некотор: некоторых
случа: случаях
сэконом: сэкономить
уйм: уйму
конкретн: конкретно
расч: расч
консьюмер: консьюмеров
формул: формуле
эрланг: эрланга
шардирован: шардирование
способ: способы
балансировк: балансировки
дедупликац: дедупликацию
сообщен: сообщений
очеред: очереди очередь
многоуровнев: многоуровневую
повторн: повторных
попыток: попыток
приоритет: приоритеты
чемпион: чемпион чемпиона чемпионов
безопасн: безопасности безопасность
рол: роль роли
стык: стыке
ит: ит
иб: иб
выигра: выиграют
информацион: информационная информационной
поговор: поговорили поговорим
руководител: руководителем
архитектур: архитектуры
мтс: мтс
создател: создателем
телегр: телеграм
кана: канала
пакет: пакет
курс: курса курсов
основ: основы
роман: романом
панин: паниным
рома: роман
внедря: внедряет
энтузиазм: энтузиазмом
сво: своим
виден: видением
продолжа: продолжаем продолжайте
дел: делиться
конспект: конспектами
алексе: алексея
барабанов: барабанова
директор: директора
хлебниц: хлебницы
специфик: специфику
нагрузк: нагрузками нагрузки
доступн: доступности доступны страницу
метод: методы
увеличен: увеличения
горизонтальн: горизонтального
масштабирован: масштабирования
настро: настроим установить
погружен: погружения
постара: постараемся
основн: основные
подводн: подводные
камн: камни
быстр: быстрое быстро
пайплайн: пайплайн пайплайна
веб: веб
сайт: сайта информация
тестирован: тестирование
программирован: программирование
перевел: перевели
создан: создании
статическ: статического
вникнут: вникнуть
технолог: технологии технологий
применя: применять
рассматрива: рассматриваются
концепц: концепции
этап: этапы
личн: личный
оп: опыт
плох: плохая
колбас: колбаса
бассейн: бассейн бассейном
крыш: крыше
инженер: инженер инженером
жив: жив
оаэ: оаэ
эмиграц: эмиграция
лайфхак: лайфхаки
гик: гиков
урбанизм: урбанизм
спикер: спикер
экс: экс
сл: сл
рма: рма
марсел: марсель марселем
ибра: ибраев
аб: абу
даб: даби
прош: прош
л: л
собеседован: собеседование
иностра: иностранном
язык: языке дзен
английск: английский
идеа: идеала
переезд: переезда
хуж: хуже
рассказа: рассказал
квартир: квартиру
жк: жк
назва: назвал
зарплат: зарплату
сто: стоит
соглаша: соглашаться
айтишник: айтишнику
планир: планирующему
жит: жить
эмират: эмиратах
хаос: хаос
инжиниринг: инжиниринг инжиниринга
опенсорс: опенсорс
фреймворк: фреймворка
разв: разв
ртыван: ртывания
клонир: клонируйте
репозитор: репозиторий
защит: защитите
рабоч: рабочие
знаком: знакомы
контейнер: контейнерами контейнеры контейнеров запуска интернета
использ: используют
ядр: ядро
хост: хоста хост
дела: делает
мобильн: мобильным
гким: гким
сторон: стороны
предпочл: предпочли
сниз: снизить
риск: риск
причинен: причинения
вред: вреда
машин: машине
операцион: операционной
достич: достичь
явля: является
расскаж: расскажем
оплачива: оплачиваемое
хобб: хобби
студент: студента студентами
ментор: ментором
гарантир: гарантирует
рм: рм
трудоустройств: трудоустройство
сраз: сразу
страниц: страницах пробную
подтвержден: подтверждение
истор: история
арт: арт
ма: ма
прим: примы
впечатлен: впечатления
тся: тся
прощ: проще
вмест: вместе
смог: смог
произвест: произвести
революц: революцию
экосистем: экосистеме
позвол: позволив ресурсы
люд: людям
запуска: запускать
многофункциональн: многофункциональная
надежн: надежная
платформ: платформа
оркестрац: оркестрации
имеет: имеет
сложност: сложности
управля: управлять
непрост: ним
трудн: непросто
контролирова: трудно
действ: правильность
выход: возможный
допустим: рамки
сам: допустимого претендует
подходя: самым
движок: инструментом
прост: определять
манифест: простых
проверя: манифестов
изменя: проверять
генерирова: изменять
ресурс: генерировать потреблением
организац: позволить
разработчик: организациям
администратор: разработчики
придержива: администраторы
стандарт: определенного
установ: стандарта
создава: настройка
запуск: создавать
перенаправ: контейнере
трафик: перенаправить
интернет: трафик
сдела: контейнер
пробн: сделать
материа: данный
претенд: материал
современ: самое
продакш: правильное
формир: продакшена
пониман: формирует
существ: понимание
альтернат: существующих
рассказыва: альтернатив
задумыва: рассказываем
узл: кластер реальные
счита: узлов
секунд: считанные
имитирова: секунды
реальн: имитировать
низк: узлы
потреблен: низким
протестирова: ресурсов
контроллер: протестировать
затрат: контроллер
средств: затратив
ответ: инфраструктуры
большинств: ответили
вопрос: большинство
вероятн: вопросов
узна: интересно
сюд: узнать
информац: сюда
дат: сайт
регистрац: дата войти
ноябр: регистрации
основан: ноября
феврал: основания
числен: февраля
местоположен: численность
росс: местоположение
представител: россия
антон: представитель
скобин: антон
аккаунт: скобин
войт: аккаунт
хаб: разделы
песочниц: авторы
устройств: песочница
документ: компаний
соглашен: документы
конфиденциальн: соглашение
услуг: конфиденциальность
корпоративн: услуги
медийн: корпоративный
реклам: медийная
нативн: реклама
образовательн: проекты
программ: образовательные
стартап: программы
спецпроект: стартапам
яндекс: спецпроекты
дзен: яндекс
поддержк: техническая
вернут: поддержка
стар: вернуться
southbridg: southbridge
highload: highload
rss: rss
anna: anna
sokol: sokol
api: api
kubernet: kubernetes
devop: devops
etcd: etcd
cacher: cacher
edeshina: edeshina
greenplum: greenplum
ao: ao
postgresql: postgresql
uniqu: unique
primari: primary
kei: key
heap: heap
append: append
optim: optimized
s: s
asa: asa
chao: chaos
engin: engineering
sovasova: sovasova
fluentd: fluentd
fluent: fluent
bit: bit
elk: elk
stack: stack
splunk: splunk
open: open
sourc: source
big: big
data: data
world: world
db: db
ansibl: ansible
practic: practices
ip: ip
nat: nat
rabbitmq: rabbitmq
zubarek: zubarek
secur: security
champion: champion
high: high
avail: availability
load: load
gitlab: gitlab
ci: ci
cd: cd
aw: aws
bucket: bucket
lika: lika
chernigo: chernigo
cto: cto
mesh: mesh
gvisor: gvisor
host: host
kernel: kernel
sandbox: sandbox
polina: polina
averina: averina
upgrad: upgrade
kyverno: kyverno
lxd: lxd
ubuntu: ubuntu
linux: linux
nginx: nginx
docker: docker
asiiat: asiiat
gadaborsheva: gadaborsheva
kubelet: kubelet
kwok: kwok
io: io
facebook: facebook
twitter: twitter
vk: vk
telegram: telegram
youtub: youtube
habr: habr
