хабр: хабр
откр: открыть
список: список
стат: стать статье статьи статьях статья
автор: автором авторы авторов
поток: потоки
разработк: разработка
администрирован: администрирование
дизайн: дизайн
менеджмент: менеджмент
маркетинг: маркетинг
научпоп: научпоп
поиск: поиск
профил: профиль профилях
обнов: обновить обновились
рейтинг: рейтинг
разработчик: разработчик разработчиков разработчики
субд: субд
блог: блог
подписчик: подписчики
сотрудник: сотрудники
нов: новые нового
скопирова: скопировать
ссылк: ссылку ссылки
показыва: показывать показывает
лучш: лучшие
примен: применить
час: часов
прочтен: прочтение
мин: мин
количеств: количество
просмотр: просмотров
компан: компании компания компаний
дайджест: дайджест
новост: новости
март: март
чита: читать
дал: далее
голос: голосов
добав: добавить
закладк: закладки
комментар: комментарии комментарий
мар: мар
приход: приходите
баз: баз базы база базу базами
дан: данных данной данная данном данный данные
конференц: конференции конференция
начал: начале
апрел: апреля
рэдиссон: рэдиссон
славянск: славянской
москв: москве
пройд: пройд
очередн: очередная очередной
постгрессист: постгрессистов
программн: программному
комитет: комитету
уда: удалось
собра: собрать собрали
интересн: интересных интересное интересные интересна
доклад: докладов доклада
част: часть
хотел: хотел хотелось
анонсирова: анонсировать
феврал: февраль февраля
аномал: аномалии аномалиях
нагрузк: нагрузкой нагрузки
ч: ч
сто: стоит
помн: помнить
борот: бороться
высок: высокая высокой
производительн: производительность производительности
песочниц: песочницы песочница
разбер: разбер
аномальн: аномальных
случа: случаев случаются случай случае случаться
оправдыва: оправдывает
ожидан: ожидания
отношен: отношении отношений
ост: оста
тся: тся
определ: определ определить
нных: нных
вест: вести
ожида: ожидаем ожидали ожидает
сосредоточ: сосредоточимся
предпочита: предпочитает
виде: видео
информац: информация информации
доступн: доступна доступные
вид: виде видится
запис: записи записей
помога: помогает
обслужива: обслуживать
мультитерабайтн: мультитерабайтные
крупн: крупных крупном
проект: проектах проекте проекты
поэт: поэтому
рассказ: рассказ
основа: основан основанном
реальн: реальном реальных
опыт: опыте
промышлен: промышленной
эксплуатац: эксплуатации
пор: порой
сталкива: сталкиваемся
вед: вед
рамк: рамках
рассмотр: рассмотрим рассмотрены
след: следующее следить следующие следует
фев: фев
номер: номере номер
сам: самое самых самые
январ: январь января
нача: начало
числ: числе числа число
релиз: релизах релиз релизе релизы
коммитфест: коммитфест коммитфестов коммитфеста коммитфесты
продолжа: продолжаем
новинк: новинками новинках
й: й
верс: версии версиях версию версия
заверш: завершился
ждет: ждет
вперед: впереди
напомн: напомню
перв: первых первого
трех: трех
прочита: прочитать
предыдущ: предыдущих предыдущей предыдущими
сер: серии серию
янв: янв
жар: жарим
хранен: хранение хранения
хранилищ: хранилища хранилище
обзор: обзор
подгор: подгорит
хран: хранит
больш: большие большего большую большое
значен: значения значение значений
столбц: столбцов
как: какие
явн: явные
неявн: неявные
ограничен: ограничения ограничениями ограничений
существ: существующего
механизм: механизма
проблем: проблемы
вызва: вызваны
реш: решить
расшир: расширить
возможн: возможности возможностей
дек: дек
постгресс: постгрессо
начин: начиная
январск: январского
устройств: устройство
битн: битных битный
сч: сч
тчик: тчиков
транзакц: транзакций транзакциям транзакцию
описыва: описывает описывать
реализац: реализацию реализации
ксид: ксидов ксиды
созда: создана создан создали создать
основ: основе
свободн: свободной
опенсорсн: опенсорсной
объектн: объектно
реляцион: реляционной
ориентирова: ориентирована
имеет: имеет
практическ: практический
оп: опыт
работ: работе работы работа
интерес: интересуется
развит: развитием развитии
сравнен: сравнение сравнению
сист: систем
таблиц: таблиц таблицы таблицами
диск: диске
организац: организацию
формат: формата формате
стара: старается
максимальн: максимально
гибк: гибким
конфигурац: конфигурации
удовлетвор: удовлетворить
запрос: запросы запросов
пользовател: пользователей пользователь пользователям
большинств: большинство
параметр: параметров параметры
например: например
так: таких таки таким
размер: размер размере
страниц: страницы
умолчан: умолчанию
кб: кб
сегмент: сегмента
гб: гб
измен: изменены
сборк: сборке сборки
сраз: сразу
обознач: обозначить
рассматрива: рассматривать рассматривались рассматривается рассматривали
вариант: вариант
котор: котором
имеют: имеют
углубля: углубляться
мультитранзакц: мультитранзакции
цел: целей
достаточн: достаточным достаточно
предположен: предположения
контекст: контексте
аналогичн: аналогичны
обычн: обычным обычных обычном
вылож: выложили
сообществ: сообщество сообществе сообществом
занима: занимаемся
активн: активным
продвижен: продвижением
идентич: идентичен
код: коду кода кодом
используем: используемому
частност: частности
вс: вс
ещ: ещ
образ: образуют
кольц: кольцо
общ: общая
иде: идея
излож: изложена изложил
текущ: текущий
момент: момент
патч: патч патчи патчей
рев: ревью
вер: верим
положительн: положительно
скажет: скажется
удобств: удобстве
использован: использования использование
устойчив: устойчивости
наде: надеемся
прин: принят
ближайш: ближайшем
будущ: будущем будущей
вопрос: вопросу вопрос вопросы
предсто: предстоит
благодарн: благодарны
жела: желающим желающих
небезразличн: небезразличным
посильн: посильное
участ: участие
вышел: вышел
павл: павла
лузанов: лузанова
образован: образование
комьюнит: комьюнити
жив: жив
жизн: жизнью
зате: затея
райа: райана
буз: буза
пятнец: пятнецы пятнец пятнеца
этап: этапе
флеш: флеш
моб: моба
ход: ход
пэт: пэта
райт: райта
отлич: отличие отличий
пятниц: пятниц
шон: шона
томас: томаса
месяц: месяц
последн: последняя последний последние
приглаша: приглашают
ответ: ответить ответ
декабр: декабря
результат: результаты
но: ноя
десятк: десятки
исправлен: исправления
баг: багов
назван: названия
времен: временных временными временные
пояс: поясов
актуальн: актуальные актуальность
возвраща: возвращаются
расскаж: расскажем
подробн: подробнее
изменен: изменения изменениям
важн: важнейшее
вошл: вошли
откат: откатили
существен: существенные
прошл: прошлом
печал: печалились
прав: правила права
исключен: исключения
навскидк: навскидку
мног: многим
знаком: знакомы знакомить
поведен: поведением
неопредел: неопредел
нны: нные
преподнос: преподносят
сюрприз: сюрпризы
предлага: предлагаем
ваш: вашему
вниман: вниманию
расшифровк: расшифровку
алексе: алексея
борщев: борщева
полност: полностью
посвящ: посвящ
н: н
особен: особенностям особенности особенностей особенностях
прост: простыми простому простую
слов: словами
согласн: согласно
одн: одному
определен: определений
набор: набор
взаимосвяза: взаимосвязанных
обрат: обратимся
бытов: бытовому
пример: примеру пример
зад: зада
друг: друг другу другую
дежурн: дежурный
дел: дела деле
получа: получаем
полож: положить
нно: нное
некорректн: некорректное
неизвестн: неизвестное
официальн: официально официальной
сет: сети
появ: появилось появилась появившиеся
множеств: множество
октябр: октября
обсуд: обсудить
июльск: июльского
окт: окт
некотор: некоторым некоторыми
причин: причинам причине
сдвоен: сдвоенный
продолж: продолжит
выход: выходить выход
ежемесячн: ежемесячном
режим: режиме
сверш: свершилось
главн: главное главных
событ: событие
общедоступн: общедоступной общедоступная
сред: среди
новшеств: новшеств
называ: называют
поддержк: поддержка
команд: команды
избирательн: избирательная
публикац: публикация публикации
содержан: содержания
благодар: благодаря
услов: условия
фильтр: фильтрах
опц: опций
сжат: сжатии сжатие сжатия
сторон: стороне
сервер: сервера
процесс: процессе процессы процессам
структурирова: структурированного
вывод: вывода
лог: логов
увеличен: увеличение
сортировк: сортировке
памят: памяти
написа: написано
останавлива: останавливаться
глянут: глянуть
кратк: краткий
умар: умара
шахид: шахида
пар: пару
ссылок: ссылок
повод: поводу
схем: схемы
произошл: произошло
фаз: фазе
связа: связанных
сен: сен
попыта: попытаться
спокойн: спокойно
жит: жить
материа: материал
одно: одноим
нног: нного
вошедш: вошедшего вошедшие
популярн: популярных
выступлен: выступлений
поскольк: поскольку
тем: тема
прежн: прежнему
сохраня: сохраняет сохранять
смотрет: смотреть
мероприят: мероприятий
люб: любят
концепц: концепция
туп: тупого тупое
год: годы
утвержда: утверждают
никак: никакой
логик: логики логикой логика
откуд: откуда
подход: подход
объясня: объясняется
сложност: сложностями сложности
миграц: миграции миграция
разв: разв
ртыван: ртывания
неудобств: неудобствами
систем: системами система системы
контрол: контроля
исходн: исходного
списыва: списывать
счет: счетов
человеческ: человеческую
лен: лень
нормальн: нормально
связыва: связываться
пуст: пусть
создаст: создаст
отличн: отлично
документ: документов документы
прощ: проще
создава: создавать
контролирова: контролировать
напряга: напрягать
мозг: мозги
автоматизирова: автоматизировано
работа: работает работать
вполн: вполне
достава: доставать
идентификатор: идентификатору
треб: требуется
реша: решать
задач: задачи
посложн: посложнее
выбира: выбирают
ограничива: ограничивается
создан: созданием создание создания
индекс: индексов
избыточн: избыточной
технолог: технология
бизнес: бизнес
инструмент: инструмент
явля: является
распростра: распростран
нным: нным
вообщ: вообще
ленив: ленивы
крайн: крайне
наивн: наивно
дистанцирова: дистанцироваться
хорош: хороших
нежелан: нежелания
заморачива: заморачиваться
приобрета: приобретать
навык: навыки
изощр: изощр
нна: нная
поня: понять
почита: почитать
уровн: уровни уровня
изоляц: изоляции
процедур: процедуры
резервн: резервного
копирован: копирования
синхронизирова: синхронизировать
избежа: избежать
убытк: убытков
авг: авг
пут: пути
обход: обхода
средств: средства средств
конвертац: конвертации конвертация
вспомогательн: вспомогательные
модул: модули модуль модулем
заверша: завершает
цикл: цикл
устоя: устоявшиеся
способ: способы
перенос: переноса перенос
трет: третьей третья
представл: представлена
учест: учесть
перевод: переводе перевод
храним: хранимого хранимым
сегодняшн: сегодняшнем
материал: материале
оста: оставшаяся
адаптац: адаптация
включ: включая
выбор: выбор
глобальн: глобальные
структур: структуры структур
пакет: пакета
рекоменд: рекомендуется
использова: использовать
позволя: позволяет
скалярн: скалярные
массив: массивы
понима: понимать
собира: собирать
статистик: статистику статистика
планировщик: планировщика
прид: прид
пользова: пользоваться
интенсивн: интенсивно
удален: удаление удаления
системн: системном системный
каталог: каталоге каталог
сообщен: сообщениям
инвалидац: инвалидации
возникнут: возникнуть
ситуац: ситуация
серверн: серверным
многократн: многократно
перечитыва: перечитывать
клиент: клиента
трат: тратили
планирован: планирование
пыта: пытались
взят: взять
соответств: соответствующие
блокировк: блокировки
объект: объекты объект объектами
соответствен: соответственно
кажд: каждую
пришл: пришлось
отказа: отказаться
реплик: реплике реплика
привод: приводит
получ: получится
дела: делать
словар: словаре
приложен: приложения
преодолен: преодоления
управлен: управления
разговор: разговор
пойд: пойд
необходим: необходимости
смен: смены
ит: ит
инфраструктур: инфраструктура
водопровод: водопровод
невозможн: невозможна
выпуска: выпускать
бет: бета
закрыва: закрывает
неожида: неожиданно
обнаружен: обнаруженную
дыр: дыру
безопасн: безопасности безопасность
объясн: объяснена
пресс: пресс
дэн: дэна
гарс: гарсии
взгляд: взгляд
ясн: яснее
лейн: лейн
рассылк: рассылке
вольност: вольностями
скрипт: скрипт
расширен: расширения расширению расширение
отрабатыва: отрабатывал
существова: существовал
принадлежа: принадлежал принадлежащими принадлежащий
переписыва: переписывало переписывались
наследова: наследовались
могл: могло
неумышлен: неумышленно
плох: плохо
злостн: злостный
заран: заранее
нужн: нужным
имен: именем
ожид: ожидая
установ: установит
атак: атакующего атаки
переписа: переписанный
модифицирова: модифицировать
запрет: запретить
операц: операции
должн: должна
исправл: исправлено
обновл: обновлены
ветк: ветка
скор: скоро
вывед: выведена
оборот: оборота
намеч: намечена
конец: конец
го: го
кварта: квартала
функциональн: функциональность
перечисл: перечислена
анализ: анализ
дни: дни
майск: майского
объяв: объявила
выпуск: выпуске выпуск выпуски
вышл: вышло
обновлен: обновлений
свеж: свежем
включа: включает
ошибок: ошибок
недавн: недавние
корректир: корректирующие
ключев: ключевые
ванильн: ванильной
наш: нашего
форк: форка
сюд: сюда
сайт: сайт сайта
дат: дата
регистрац: регистрации регистрация
сентябр: сентября
основан: основания
числен: численность
местоположен: местоположение
росс: россия
представител: представитель
ива: иван
панченк: панченко
аккаунт: аккаунт
войт: войти
раздел: разделы
хаб: хабы
соглашен: соглашение
конфиденциальн: конфиденциальность
услуг: услуги
корпоративн: корпоративный
медийн: медийная
реклам: реклама
нативн: нативные
образовательн: образовательные
программ: программы
стартап: стартапам
мегапроект: мегапроекты
яндекс: яндекс
дзен: дзен
настройк: настройка
язык: языка
техническ: техническая
вернут: вернуться
стар: старую
postgr: postgres
profession: professional
pro: pro
rss: rss
igor: igor
le: le
postgresso: postgresso
postgresql: postgresql
x: x
wao: wao
pgconf: pgconf
russia: russia
mizhka: mizhka
highload: highload
enterpris: enterprise
pluzanov: pluzanov
sql: sql
billexp: billexp
toast: toast
open: open
sourc: source
orlovmg: orlovmg
xid: xid
postrg: postrges
blcksz: blcksz
segsiz: segsize
ru: ru
en: en
ryan: ryan
booz: booz
pgsql: pgsql
phridai: phridays
pat: pat
wright: wright
pg: pg
commun: community
standard: standard
json: json
aborschev: aborschev
null: null
beta: beta
rc: rc
ga: ga
gener: general
avail: availability
releas: released
merg: merge
zstandard: zstandard
zstd: zstd
basebackup: basebackup
featur: features
excit: excited
umair: umair
shahid: shahid
percona: percona
public: public
plumqqz: plumqqz
constraint: constraints
onlin: online
orm: orm
nosql: nosql
ppetrov: ppetrov
oracl: oracle
pl: pl
variabl: variables
statist: statistic
class: class
dan: dan
garcia: garcia
edb: edb
tom: tom
lane: lane
committ: committers
creat: create
replac: replace
exist: exists
vacuum: vacuum
foundat: foundation
www: www
postgrespro: postgrespro
facebook: facebook
twitter: twitter
vk: vk
telegram: telegram
youtub: youtube
habr: habr
