хабр: хабр хабре
откр: открыть
список: список
стат: стать статьи статья статье статью
автор: автором авторы авторов
поток: потоки
разработк: разработка разработку разработкой разработки разработке
администрирован: администрирование
дизайн: дизайн дизайна
менеджмент: менеджмент
маркетинг: маркетинг
научпоп: научпоп
поиск: поиск
профил: профиль
обнов: обновить
рейтинг: рейтинг рейтинга
производств: производство производства производстве
электроник: электроники электроника электронику
налад: наладить
процесс: процесс процесса
компан: компании компаний компанию
подряд: подряд
скопирова: скопировать
ссылк: ссылку
показыва: показывать
нов: новые
лучш: лучшие лучших
порог: порог
уровен: уровень
сложност: сложности
прост: простой прост
средн: средний
сложн: сложный сложнейших сложной
примен: применить
час: часа часов час
настройк: настройка
пошагов: пошаговой пошаговая
отладк: отладки отладка
прочтен: прочтение прочтении
мин: мин
количеств: количество
просмотр: просмотров
программирован: программирование программирования
промышлен: промышленное промышленность
микроконтроллер: микроконтроллеров микроконтроллера
начина: начинающих
туториа: туториал
записа: записали
прошивк: прошивку прошивка прошивки
интерфейс: интерфейс интерфейсы интерфейсу интерфейсов интерфейса
происход: происходит
мига: мигает
лог: логи
появля: появляются
отвеча: отвечает
очевидн: очевидно
зависл: зависла
дела: делать делают делается
поня: понять
ошибк: ошибка
выруч: выручит
подсветк: подсветкой
чита: читать
дал: далее
добав: добавить добавил
закладк: закладки
комментар: комментарии
новост: новости
ретр: ретро
компьютер: компьютер
уровн: уровня уровне
рад: радио
рк: рк
процессор: процессором процессоры процессорах процессоре процессоров
плат: плате платы плат платах плата
сдела: сделай сделать сделанные
песочниц: песочницы песочница
недорог: недорогой
отладочн: отладочной
плис: плис
получ: получить получим получилось
монитор: монитором
клавиатур: клавиатурой
тетрис: тетрисом
современ: современным современных
баз: базе
компилятор: компилятором
голос: голосов
возможн: возможности возможностях возможностей возможность
перспектив: перспективы перспективах
применен: применения
беспроводн: беспроводные
технолог: технологии технологиям технологий
стандарт: стандарты
связ: связи
научн: научно
популярн: популярное популярно популярные
интернет: интернет
вещ: вещей вещами
привет: привет
зовут: зовут
павел: павел
техническ: технический технических техническая
писател: писатель
хаус: хауса
хоч: хочу
рассказа: рассказать
последн: последнее
вс: вс
оказыва: оказывается
фокус: фокусе
вниман: внимания
информацион: информационных информационная информационной
ресурс: ресурсов
упомина: упоминается
связк: связке
флагманск: флагманскими
продукт: продуктами
крупн: крупных
обзорн: обзорная
должн: должна
дат: дать
общ: общее
представлен: представление
сфер: сферах
вариант: вариантах вариант
использован: использования использованием
электронщик: электронщиков
анатом: анатомия
кана: канала
передач: передачи передач
блог: блог
компьютерн: компьютерное компьютерным
желез: железо железе
перевод: перевод
предыдущ: предыдущий предыдущей
разбира: разбирали
дифпар: дифпары
основ: основы основе
прав: правила
разводк: разводки
известн: известные
допуск: допуски
отношен: отношении
поговор: поговорим
конкретн: конкретных
сигнал: сигналах
работа: работает работал
узна: узнаем
как: какие каком какого
разъ: разъ
применим: применимы
истор: истории историей история
причин: причина причиной
агон: агонии агония
студент: студентов
интерв: интервью
модел: моделях модели
шин: шины шине
ненормальн: ненормальное
алгоритм: алгоритмы
кейс: кейс
интервьир: интервьирую
кандидат: кандидатов кандидаты
приход: приходят приходилось прихода
позиц: позиции
проектировщик: проектировщики
микросх: микросхем микросхему
регистров: регистровых
интервьирова: интервьировал
инженер: инженеров инженера
верификатор: верификаторы
блок: блоков
мо: моим моих мое
стандартн: стандартным
вопрос: вопросом вопросе вопросы вопрос
написа: написать
маркер: маркером
доск: доске
псевдокод: псевдокод
упрощен: упрощенного
драйвер: драйвера
протокол: протокола
наступа: наступала
уж: ужи
сковородк: сковородке
пыта: пытались пытается
натянут: натянуть
сов: сову
глобус: глобус
приспособ: приспособить
решен: решение решений решения
последовательн: последовательной
ля: ля
котор: которое
прочита: прочитали
тьюториал: тьюториале
перв: первых первом
конвейерн: конвейерная
втор: вторых
допуска: допускает
внеочередн: внеочередные
ответ: ответы
запрос: запросы
чтен: чтения
разн: разными
идентификатор: идентификаторами
аналог: аналогия
област: области область
представьт: представьте
обход: обходить
дерев: дерево
реш: решить решил решено
ханойск: ханойские
башн: башни
зна: зная
концепц: концепций концепции
рекурс: рекурсии
стек: стека
ориентирова: ориентированной
архитектур: архитектуры
глуп: глупые
восстановлен: восстановление восстановления восстановлению
утрачен: утраченного
регенеративн: регенеративная регенеративные регенеративных регенеративной
биоэлектроник: биоэлектроника биоэлектроники
мозг: мозг
здоров: здоровье
организм: организм организма организму
человек: человека
удивительн: удивительный
механизм: механизм
способн: способный способности способностей
выполня: выполнять
множеств: множество
функц: функций
одновремен: одновременно
мног: многие многом
аспект: аспекты
строен: строения
функциона: функционала
химическ: химического
состав: состава
то: той
ин: иной иная
част: части часть
наш: нашего
тел: тела
кажут: кажутся
обыден: обыденными
благодар: благодаря
колоссальн: колоссальному
исследовательск: исследовательскому
труд: труду
длит: длится
век: веков
уда: удалось удается
установ: установить
предел: пределы
преодолет: преодолеть
обыгра: обыграть
природ: природу природы
пример: примеру примеров
достаточн: достаточно
скудн: скудные
сравнива: сравнивать
саламандр: саламандрами
одн: одним
сам: самых самым
ярк: ярких
ограничен: ограниченности ограничениях ограничения ограничений
явля: является
невозможн: невозможностью
полноцен: полноценно
восстанавлива: восстанавливать
нервн: нервные
окончан: окончания
сможет: сможет
функционирова: функционировать
ткан: ткани
поврежд: повреждены
учен: ученые ученых
кембриджск: кембриджского
университет: университета
великобритан: великобритания
попытк: попытках
пробл: проблему
разработа: разработали разработать
метод: метод метода
ампутирова: ампутированного
периферическ: периферического
нерв: нерва
биогибридн: биогибридной
леж: лежит
дан: данного данные данных
реализ: реализуется
наскольк: насколько
эффектив: эффективен
найд: найдем
доклад: докладе
мар: мар
тройн: тройные
зарплат: зарплаты
национальн: национальный национального
инструментар: инструментарий инструментария
кита: китай китаю
реша: решает решается
чип: чипов чипах чипа чипы чип
исследован: исследования
прогноз: прогнозы
тем: тема тему
кит: китая
затрагива: затрагивалась
кнр: кнр
санкц: санкций санкции
развернут: развернуть
собствен: собственную собственного собственный собственные собственных
инфраструктур: инфраструктуру инфраструктура
электрон: электронных электронную
сист: систем
работ: работа
ведет: ведется
перемен: переменным
успех: успехом
суд: судить
понемног: понемногу
быстр: быстро быстрый
хотел: хотелось
правительств: правительству
бизнес: бизнесу бизнес
стран: страны
ускорен: ускорения
импортозамещен: импортозамещения импортозамещение
фактор: фактора
проектирован: проектирования
охот: охоту
голов: головами
подробн: подробности
кат: катом
разрабатыва: разрабатывать
контракт: контракту
загнут: загнуться
ретроспектив: ретроспектива
ива: иван
ларион: ларионов
вмест: вместе вместо
брат: братом
основа: основали
пин: пин
подел: поделиться
эволюц: эволюции
фрилансер: фрилансера
руководител: руководителя
занима: занимающейся занимался занималась занимаюсь
контрактн: контрактной
обанкрот: обанкротиться
закр: закрыться
выгорет: выгореть
нараст: нарастить
мощност: мощности
сохран: сохранить
кураж: кураж
аппаратн: аппаратные
микроскоп: микроскопом
обнаружен: обнаружение
безопасн: безопасность безопасности
дисклеймер: дисклеймер
сообществ: сообществе
специалист: специалистов
ид: ид
дискусс: дискуссия
внедрен: внедрения
троян: троянов
коммерческ: коммерческие
микросхем: микросхемы
сожален: сожалению
чист: чисто
вмешива: вмешиваются
политическ: политические
аргумент: аргументы
мол: мол
дава: давайте
переход: переходить
российск: российские
западн: западных
типичн: типичный
см: см
контрпропаганд: контрпропаганду
кстат: кстати
американск: американские американских
коллег: коллеги
использ: используют используется
китайск: китайских китайское китайские
микрочип: микрочипов
похож: похоже
политик: политики
люб: любят
использова: использовать использовали
пугалк: пугалки
принят: принятия принятые
выгодн: выгодных
искусств: искусство
древн: древнее
человечеств: человечества
хот: хотим
ещ: ещ
подчеркнут: подчеркнуть
исследу: исследуем
исключительн: исключительно
общемиров: общемировом
контекст: контексте
важн: важную важно
микроэлектроник: микроэлектроники
факт: факты
ангажирова: ангажированные
представител: представители
индустр: индустрии
пуст: пусть
останет: останется
совест: совести
дел: дела дело
продажн: продажные
управлен: управление
персонал: персоналом
читальн: читальный
зал: зал
продаж: продажами продаж продажи
пересека: пересекаться
плотн: плотно
подразделен: подразделение
называ: называлось называемая
отдел: отдел
больш: большей большой
поддержк: поддержкой поддержка
основн: основном основные
быва: бывало
долг: долгу
служб: службы
взаимодействова: взаимодействовать
интел: интел
вынес: вынесены
отдельн: отдельную отдельные
групп: группу
махров: махрового
иб: ибо
счита: считалось
взаимоотношен: взаимоотношения
клиент: клиентом
первичн: первичны
продава: продавать
поскольк: поскольку
парнишк: парнишкой
любопытн: любопытным
страшн: страшно
интересн: интересно
сейл: сейлов
посвящ: посвящена
глав: глава
цел: цели
этап: этапы этапах
хранилищ: хранилища
излож: изложена
иде: идея
портирован: портирования
софт: софта
корпус: корпуса корпусах
рассказыва: рассказывается
открыт: открытой открытого
платформ: платформы
модульн: модульной
конструкц: конструкции
представл: представлен
началн: началный
модул: модуля модулей
структурн: структурная
схем: схема схем
универсальн: универсальной
несущ: несущей
подключен: подключения подключение
различн: различных
числ: числе
контроллер: контроллеров контроллера
диск: дисков
сетев: сетевых
адаптер: адаптеров
перифер: периферии
привод: приводятся
результат: результаты результат
сборк: сборки
нескольк: нескольких
проверк: проверки
концепт: концепта
любител: любителей
чиплет: чиплетов
производител: производители производителей
ситуац: ситуации
постепен: постепенно
перекрыва: перекрывают
воздух: воздух
доступ: доступ
международн: международным
понятн: понятно
стара: старается стараются
выйт: выйти
положен: положения
ко: кое
получа: получается
например: например
заяв: заявили
проект: проект проекта проектах проектов проекты
дает: дает
уйт: уйти
китайц: китайцы
сервопривод: сервоприводов
введен: введение
робототехник: робототехники
продолжен: продолжение
провед: провед
н: н
анализ: анализ
выбор: выбор выборе
изуч: изучена
осво: освоена
сред: среда
подошл: подошла
собра: собранная
знакомств: знакомство
дифференциальн: дифференциальными
пар: парами
представля: представляет
мощн: мощный
опиш: опишу
принцип: принципы
поначал: поначалу
пуга: пугать
эксперимент: экспериментов
вполн: вполне
пригод: пригоден
рамк: рамках
хобб: хобби
определ: определ
нны: нный
момент: момент моменты
может: можете
задействова: задействовать
готов: готовым
слыша: слышали
язык: язык языка
прода: продан продали продающей
доллар: долларов
высок: высокая
производительн: производительность производительности
параллельн: параллельное
знают: знают
поменьш: поменьше
предшественник: предшественник
знает: знаете
букв: буквы
маленьк: маленькой маленького маленький
наверн: наверное
подума: подумали
безызвестн: безызвестный
аспирант: аспиранта
провинциальн: провинциального
европейск: европейского
интерпретатор: интерпретатор
назван: названием
милион: милионов
прич: причем
президент: президента
звал: звали
гаврил: гаврилов
нагугл: нагуглить
внутр: внутри
так: такого таких
вызва: вызвало
интерес: интерес
толст: толстых
богат: богатых
корпорац: корпораций
извлека: извлекаем
фотограф: фотографии фотографий
реверс: реверс
инжиниринг: инжиниринг
предлага: предлагается
начн: начн
изобража: изображающих
металлическ: металлическими
соединен: соединениями соединения
выход: выходе
файл: файл
дизассемблирова: дизассемблировать
эмулирова: эмулировать
гаджет: гаджет
подход: подходит
постоя: постоянная
памя: память
программируем: программируемая
перемычк: перемычками
означа: означает
бит: биты
кодир: кодируются
сло: слоями
считыва: считывать
поверхн: поверхности
невелик: невелика
поэт: поэтому
смог: смог
включ: включить
репозитор: репозиторий
сэконом: сэкономив
недел: недели
могл: могли
потрат: потратить
исправлен: исправление
мелк: мелких
побитов: побитовых
ошибок: ошибок
ноксвилл: ноксвилла
трэвис: трэвис
гудспид: гудспид
останов: остановитесь
замедля: замедляет
экспорт: экспорта
экспортн: экспортных экспортной
торгов: торговых торговые
применя: применяет
сша: сша
поднебесн: поднебесной
писа: писали писал
неоднократн: неоднократно
сильн: сильно
меша: мешают
развива: развивать
партнер: партнеры
науч: научились
реч: речь
идет: идет
поставк: поставках
графическ: графических
ускорител: ускорителей
сторон: стороны
каза: казалось
соблюда: соблюдать
торговл: торговли
помощ: помощи
искусствен: искусственного
аналогичн: аналогичным
образ: образом
поступа: поступают
попа: попали
сил: силами
избежа: избежать
бегущ: бегущая
строк: строка
сво: своими
рук: руками
симулятор: симуляторы симуляторам симуляторе
добр: добра
доведут: доведут
относ: относитесь
плюет: плюется
нрав: нравится
лен: лень
отлипа: отлипать
дива: дивана
треб: требует
схемотехник: схемотехники
взгляд: взгляд
отличн: отличная
альтернатив: альтернатива
игрушк: игрушкам
возникновен: возникновения
выходн: выходного
дня: дня
удачн: удачного
моделирован: моделирования
случ: случилось
досимулирова: досимулировался
жизнеспособн: жизнеспособное
устройств: устройство устройства
воплот: воплотить
реальн: реальном
мир: мире
скук: скуки
увлека: увлекается
рыбалк: рыбалкой
ход: ходит
рек: реку
удочк: удочкой
снаст: снастей
приманок: приманок
покупа: покупаю
радиодета: радиодетали
заказыва: заказываю
печатн: печатные
пайк: пайка
сродн: сродни
медитац: медитации
дым: дым
канифол: канифоли
слащ: слаще
калья: кальяна
пост: пост
пая: паять
пришл: пришлось
выбра: выбрать
оптимальн: оптимальный
способ: способ
детал: деталей
пластиков: пластиковых
вывод: выводы вывод
помогут: помогут
накосяч: накосячить
ваш: вашего
минимум: минимум
критическ: критически
оцен: оценить
смотрет: смотреть
картинк: картинки
формул: формулы
двусторон: двустороннего
определен: определения
дальност: дальности
трансивер: трансиверами трансиверы
математик: математика математику
наста: настал
случа: случай
професс: профессии
программист: программист
понадоб: понадобилось
вспомн: вспомнить
школьн: школьную
текст: тексте
представ: представил
мест: места
неочевидн: неочевидны
нужн: нужна
расстоян: расстояния
двум: двумя
определя: определять
отправк: отправки
радиоволн: радиоволны
умеют: умеют
сюд: сюда
вклад: вклад
аккаунт: аккаунт
войт: войти
регистрац: регистрация
раздел: разделы
публикац: публикации
хаб: хабы
информац: информация
сайт: сайта
документ: документы
соглашен: соглашение
конфиденциальн: конфиденциальность
услуг: услуги
корпоративн: корпоративный
медийн: медийная
реклам: реклама
нативн: нативные
образовательн: образовательные
программ: программы
стартап: стартапам
мегапроект: мегапроекты
яндекс: яндекс
дзен: дзен
вернут: вернуться
стар: старую
верс: версию
rss: rss
aabzel: aabzel
jlink: jlink
eclips: eclipse
swd: swd
jtag: jtag
heartbeat: heartbeat
led: led
uart: uart
cli: cli
gdb: gdb
dmitryzlobec: dmitryzlobec
risc: risc
omdazz: omdazz
fpga: fpga
dii: diy
c: c
cycloneiv: cycloneiv
ep: ep
ce: ce
rsic: rsic
gcc: gcc
drezzzina: drezzzina
uwb: uwb
notanotheron: notanotherone
ultra: ultra
wideband: wideband
bright: bright
translat: translate
pcie: pcie
ruvd: ruvds
yuripanchul: yuripanchul
rtl: rtl
design: design
dv: dv
verif: verification
bu: bus
function: functional
model: model
bfm: bfm
axi: axi
apb: apb
gui: gui
dmytro: dmytro
kikot: kikot
ua: ua
host: hosting
compani: company
greiv: greiv
selectel: selectel
ioanlarionov: ioanlarionov
alizar: alizar
fud: fud
vvvphoenix: vvvphoenix
intel: intel
r: r
d: d
develop: developer
relat: relations
divis: division
respons: response
team: team
pre: pre
sale: sales
post: post
market: marketing
group: group
smg: smg
wearabl: wearables
perform: performance
comput: computing compute
sdy: sdy
na: nas
man: man
arm: arm
rk: rk
sagidullin: sagidullin
indemsi: indemsys
mc: mc
open: open
sourc: source
pci: pci
express: express
raspberri: raspberry
pi: pi
modul: module
e: e
f: f
b: b
specman: specman
cadenc: cadence
system: systems
veris: verisity
sivchenko: sivchenko
gameboi: gameboy
mask: mask
rom: rom
nintendo: nintendo
github: github
nvidia: nvidia
gpu: gpu
oldfashionedengin: oldfashionedengineer
timeweb: timeweb
cloud: cloud
arduino: arduino
id: ide
isi: isis
proteu: proteus
anvo: anvos
appnot: appnote
mathemat: mathematics
rang: ranging
dw: dw
zhovner: zhovner
amartolog: amartology
promwad: promwad
olartamonov: olartamonov
alekdikarev: alekdikarev
seleditor: seleditor
data: data
center: center
miran: miran
facebook: facebook
twitter: twitter
vk: vk
telegram: telegram
youtub: youtube
habr: habr
