хабр: хабр
откр: открыть
список: список
стат: стать статьи
автор: автором авторы авторов
поток: потоки
разработк: разработка
администрирован: администрирование
дизайн: дизайн
менеджмент: менеджмент
маркетинг: маркетинг
научпоп: научпоп
поиск: поиск
профил: профиль
обнов: обновить
минут: минуту
систем: система системе системы
кругов: кругового круговой
обзор: обзора обзор
видеокамер: видеокамерой
враща: вращающимися вращающихся вращающиеся
зеркал: зеркалами зеркале
уровен: уровень
сложност: сложности сложность
средн: средний
прочтен: прочтение
мин: мин
количеств: количество
просмотр: просмотров
автомобильн: автомобильные
гаджет: гаджеты гаджетом
высок: высокая
производительн: производительность
занимательн: занимательные
задачк: задачки
работ: работа
виде: видео
фототехник: фототехника
песочниц: песочницы песочница
пиш: пишу
тип: типа
критик: критикуйте
физик: физику
математик: математику
изуча: изучал
ид: идеи
кажут: кажутся
перспективн: перспективными
став: ставят
камер: камер камеру камеры
периметр: периметру
охраня: охраняемой
территор: территории
рыб: рыбий
глаз: глаз
бампер: бампер
авт: авто
неприятн: неприятными
искажен: искажениями
сторон: стороны сторону
глядет: глядеть
напас: напас
шься: шься
широконаправлен: широконаправленные
качествен: качественные
середин: середины середину
объект: объекта объекты объектив объектами
сверх: сверху
обозрет: обозреть
принцип: принципе принципы принципа
вс: вс
полн: полную
сфер: сферу
исключ: исключая
корпус: корпус
гц: гц
небольш: небольшим
зеркальн: зеркальный зеркального
датчик: датчик датчика
зд: зд
подсказа: подсказать
сам: самые самый
интересн: интересные интересным интересная
опасн: опасные опасность опасной
помощ: помощью
нейросет: нейросетей нейросети
определ: определить определ
расстоян: расстояние расстоянии
люб: любого любой
габарит: габариты
вычисл: вычислить
скорост: скорость скоростью скорости
направлен: направление направления
текущ: текущую
шник: шников
найд: найд
тся: тся
выгляд: выглядит
схем: схема
слев: слева
вверх: вверху
схематическ: схематический
вид: вид
сбок: сбоку
справ: справа
пояснен: пояснение
физическ: физического
несмаз: несмаза
экспозиц: экспозиции экспозицию
име: имеем
больш: больших большой
соосн: соосных
монотон: монотонно
крутя: крутящихся
кольц: кольца
ккз: ккз
сер: серые
одинаков: одинаковой
углов: угловой угловые
одн: одну одно
стко: стко
прикрепл: прикреплены
зерка: зеркала зеркал
з: з
ч: ч
рны: рные
внешн: внешнего внешнее внешнем
смотр: смотрят
разн: разные разных
как: какие
треб: требуются
принима: принимают
оттуд: оттуда
пучк: пучки
свет: света светит
пс: пс
красн: красные красная красный красным
отража: отражают отражающими
внутрен: внутреннее внутреннего
располож: расположены
регулярн: регулярно
перенаправля: перенаправляют
мно: мно
штампова: штампованное
крашен: крашеного
серебрянк: серебрянкой
пластик: пластика
идеальн: идеально
ровн: ровными ровно
поверхн: поверхностями
сто: стоить
недор: недорого
основн: основное
быстр: быстрая быстро быстрее
плавност: плавность
вращен: вращения вращением вращении
деш: деш
вы: вые
смартфон: смартфоны
подойт: подойти
времен: временем
разобра: разобравшись
подстро: подстроив
кадров: кадровую
частот: частоту
съ: съ
мки: мки
управл: управляя
блютус: блютусам
общ: общаясь
друг: друг другом друга
сопоставл: сопоставляя
картинк: картинки
стере: стерео
метод: метода
запуск: запуская
распозна: распознающие
скле: склеить
размест: разместив
н: н
круг: кругу
призм: призм
двум: двумя
гран: гранями
взам: взамен
соседн: соседних
пар: паре пары пара пару
обычн: обычная
порядк: порядка
нескольк: нескольких
миллиметр: миллиметров
набор: набор
займ: займ
сантиметр: сантиметров
диаметр: диаметре
высот: высоте
размер: размер размеры
зрачк: зрачка
современ: современные
технолог: технологии
позвол: позволят
мотор: моторах
завис: зависит
способн: способностей
перейд: перейд перейдя
прав: правой
част: части часть
рисунк: рисунка
доказательств: доказательству
изображен: изображения
внутр: внутри
светочувствительн: светочувствительной
матриц: матрице
отражен: отражении отражений отражение отражения
оптик: оптике
закон: закон
линз: линза
проходя: проходящие
сквоз: сквозь
параллельн: параллельные параллельным параллельных параллельность параллельно
луч: лучи
собира: собирает
точк: точку
сво: сво свой
фокусн: фокусном
сдвинет: сдвинется
образ: образом
нестрашн: нестрашно
попа: попал
прелом: преломится
попад: попад
пиксел: пиксел
неда: недал
ким: кими
смещен: смещении
наблюдател: наблюдателя
меня: меняют меняются менять
угол: угол
мух: муха
например: например
см: см
нерезк: нерезкой
вмест: вместо
потер: потери
общност: общности
остав: оставим
мест: месте
измен: изменим изменится
входя: входящего
выход: выходе
оста: остался
оранжев: оранжевый оранжевым
очевидн: очевидно
выходя: выходящими выходящий выходящего
вход: входе
непараллельн: непараллельны
аналогичн: аналогично
перв: первого
втор: второго второе
ещ: ещ
правд: правда
ближайш: ближайшем
наблюда: наблюдать наблюдаемого
след: следующих
пол: поле
зрен: зрения зрение
последн: последнего
дойд: дойд
неизмен: неизменным неизменной
возможн: возможно
отраж: отраж
нным: нным
относительн: относительно
неко: некоей
лин: линии
обратн: обратно
глобальн: глобальной
координат: координат
увид: увидим
процесс: процессе
начальн: начальному
двумерн: двумерного
случ: случая
тр: тр
хмерн: хмерный
откуд: откуда
сниз: снизу
пригод: пригодиться
наш: наших
рассмотрен: рассмотренные
представля: представлять
пересечен: пересечения
горизонтальн: горизонтальной горизонтальную горизонтальная горизонтальный горизонтально
плоскост: плоскостью
вектор: вектор
случа: случае
разб: разбить
составля: составляющие
вертикальн: вертикальную вертикальной вертикальная вертикально
ос: оси
кажд: каждого
куск: куска кусков
траектор: траектории
останет: останется
положительн: положительно
рассмотр: рассмотрена
выш: выше
точн: точно точные
отправ: отправит
видел: видели
поворот: поворота
идт: идти
первичн: первичному
фиксирова: фиксироваться
смаз: смазов смаз
дрож: дрожь
все: всей
движен: движении
отдельн: отдельная
проблем: проблема
взглян: взглянем
наверх: наверх
видн: видны
пролета: пролетающие
стабильн: стабильные
окружа: окружающей
действительн: действительности
поступательн: поступательно
равномерн: равномерно
наезжа: наезжающие
пожир: пожирая
сосед: соседа
границ: границах
сложен: сложение
картинок: картинок
равн: равно
прол: прол
хорош: хорошего
зафиксиру: зафиксируем
разделя: разделять
промежутк: промежутками
чернот: чернотой
уменьша: уменьшать
должн: должны
знат: знать
очередн: очередная
стартова: стартовать
стопа: стопать
услов: условия
освещен: освещения
реалтаймов: реалтаймового
отличн: отличных
вкусняшек: вкусняшек
противоположн: противоположных
кра: краях
смотря: смотрящих
дающ: дающих
бинокулярн: бинокулярное
достаточн: достаточно
баз: базой
шир: шире
необходим: необходимости
сопоставля: сопоставлять
вычисля: вычислять
дистанц: дистанции
задач: задача
уменьш: уменьшить
нны: нный
вертика: вертикали
обозрева: обозревали
емк: емкий
сектор: сектор
градус: градусов
крут: крутится
стки: сткие
противоход: противоход
проход: проходя
посыла: посылать
правильн: правильный
сильн: сильно
эконом: экономим
пространств: пространство
миниатюрн: миниатюрные
двигател: двигатели
тег: теги
хаб: хабы
рейтинг: рейтинг
добав: добавить
закладк: закладки
комментар: комментарии
карм: карма
пользовател: пользователь
комментирова: комментировать
публикац: публикации
лучш: лучшие
сутк: сутки
похож: похожие
истор: истории
аккаунт: аккаунт
войт: войти
регистрац: регистрация
раздел: разделы
новост: новости
компан: компании компаний
информац: информация
устройств: устройство
сайт: сайта
документ: документы
соглашен: соглашение
конфиденциальн: конфиденциальность
услуг: услуги
корпоративн: корпоративный
блог: блог
медийн: медийная
реклам: реклама
нативн: нативные
проект: проекты
образовательн: образовательные
программ: программы
стартап: стартапам
спецпроект: спецпроекты
яндекс: яндекс
дзен: дзен
настройк: настройка
язык: языка
техническ: техническая
поддержк: поддержка
вернут: вернуться
стар: старую
верс: версию
witf: witfed
rfc: rfc
facebook: facebook
twitter: twitter
vk: vk
telegram: telegram
youtub: youtube
habr: habr
