хабр: хабр хабре хабра
откр: открыть
список: список
стат: стать статьи статье статьям статья
автор: автором авторы авторов
поток: потоки
разработк: разработка разработкой разработки
администрирован: администрирование
дизайн: дизайн
менеджмент: менеджмент
маркетинг: маркетинг
научпоп: научпоп
поиск: поиск
профил: профиль
обнов: обновить
рейтинг: рейтинг рейтинга
компьютерн: компьютерное
желез: железо
мат: мать
видюх: видюха
памя: память
звук: звук
вс: вс
компан: компании компаниями компания компаний
подряд: подряд
скопирова: скопировать
ссылк: ссылку
показыва: показывать
нов: новые нового новых новый новым
лучш: лучшие лучших лучший
порог: порог
уровен: уровень
сложност: сложности
прост: простой прост
средн: средний
сложн: сложный сложные
примен: применить
час: часов часы
портативн: портативные
консол: консоли
весн: весны весной
модел: моделей модели
сто: стоит
обрат: обратить обратимся
вниман: внимание
прочтен: прочтение
мин: мин мини
количеств: количество
просмотр: просмотров
блог: блог
гаджет: гаджеты гаджет
игр: игры
игров: игровые
выходн: выходные
отдыха: отдыхать
вид: видов виде
отдых: отдыха
видеоигр: видеоигры видеоиграх
устройств: устройств устройством устройство
созда: создано
включ: включая включить
известн: известных известные известно
девайс: девайсов девайсах девайс девайсы
именит: именитые
создава: создаваемые
небольш: небольшими небольшой
либ: либо
организац: организациями
врод: вроде
специализир: специализируются
сред: среди
многообраз: многообразия
весьм: весьма
удачн: удачные
позволя: позволяют
игра: играть
дорог: дороге дорогие
дом: дома дом
тв: тв
клавиатур: клавиатур
контроллер: контроллеров
так: таких такую
пойдет: пойдет
реч: речь
чита: читать
добав: добавить
закладк: закладки
комментар: комментарии
новост: новости новостям новостей
электронщик: электронщиков
анатом: анатомия
кана: канала
передач: передачи
интерфейс: интерфейсы интерфейсу интерфейс
производств: производство производством
электроник: электроники электроника
сдела: сделай сделать сделаем
перевод: перевод
предыдущ: предыдущий предыдущую
разбира: разбирали
дифпар: дифпары
основ: основы
прав: правила
разводк: разводки
допуск: допуски
отношен: отношении
поговор: поговорим
конкретн: конкретных конкретного
сигнал: сигналах
работа: работает работать работала работают
узна: узнаем
как: какие какую каком каким
разъ: разъ
применим: применимы
голос: голосов
мар: мар
кофемашин: кофемашина
открыт: открытым
исходн: исходным
код: кодом
нул: нуля
научн: научно
популярн: популярное популярнее популярные
туториа: туториал
эспресс: эспрессо
машин: машины машину
загадочн: загадочные
штук: штуки штука
тяжел: тяжело
обслужива: обслуживать
ещ: ещ
жит: жить
коф: кофе
никак: никаких
преград: преград
например: например
дал: далее
роутер: роутер роутеры роутера
поддержк: поддержкой поддержка
куп: купить
сетев: сетевое
оборудован: оборудование
обзор: обзор
помн: помню
домашн: домашние домашнего домашний
возможн: возможность возможности возможностях возможное
установ: установить установилась
неофициальн: неофициальную неофициальных
прошивк: прошивку прошивка прошивке прошивки
начина: начинал начинающих
стабильн: стабильнее
появ: появилась появившегося
добавля: добавлять
пакет: пакеты пакетов
расширя: расширяющие расширять
функциональн: функциональность
благодар: благодаря
бурн: бурному
развит: развитию развития
архитектур: архитектуры архитектура архитектур
мож: можем
приобрест: приобрести
мощн: мощные мощный мощными мощнейшими
компактн: компактные
железк: железки железку
адекватн: адекватную
стоимост: стоимость
производител: производители производителя
нача: начали начались
прошивок: прошивок
нужн: нужна
модем: модема
мног: многие многим
предостав: предоставить
коробк: коробки
фукциона: фукционала
хвата: хватает
хочет: хочется
больш: большего
смотрет: смотреть
сторон: сторону
последн: последние последней последнему
фавор: фаворит
баз: базе
ядр: ядра
полноцен: полноценная полноценном
операционк: операционка
сво: свой
менеджер: менеджер
проник: проник
истор: истории история
маршрутизатор: маршрутизатор
стар: старого старое старую
пк: пк
лишн: лишних
детал: деталей
подойд: подойд
офис: офиса
ответ: ответ
завис: зависит
множеств: множества
фактор: факторов
одн: одних одном одну
сам: самое самый самых самым
качествен: качественный
корпус: корпус
антен: антенны
энергопотреблен: энергопотребление
выбира: выбирает
жност: жности
отзыв: отзывам
коллег: коллег коллеги
особ: особая
категор: категория
пользовател: пользователей
котор: которым которую
наплева: наплевать
смотр: смотрят смотря
совершен: совершенно
друг: другим
угл: углом
маршрутизац: маршрутизация
программн: программная
функц: функция
собра: собрать
угодн: угодно
главн: главное
свободн: свободной
линукс: линуксе
удобств: удобства
управлен: управления
подума: подумать подумал
обычн: обычный
компьютер: компьютер компьютеры компьютеров компьютерами компьютере компьютера
слегк: слегка
допилен: допиленный
кондиц: кондиции
весен: весенние
предлага: предлагают предлагается
март: марте
настольн: настольные
миниатюрн: миниатюрные
нрав: нравятся нравится
достоинств: достоинств
бесшумн: бесшумность
мал: малый
шум: шума
активн: активным
охлажден: охлаждением
плюс: плюс
убра: убрать
глаз: глаз
дол: долой
подвес: подвесив
задн: задней
крышк: крышке
монитор: монитора
представ: представили представила
интересн: интересных интересного интересные
производительн: производительные
использова: использовать использоваться
качеств: качестве
рабоч: рабочей
лошадк: лошадки
подробн: подробности
кат: катом кат
смартфон: смартфоны
дайджест: дайджест
вышл: вышла
рассказыва: рассказываем
стал: стали стало
гарнитур: гарнитуру
смеша: смешанной
реальност: реальности
показа: показали
отреагирова: отреагировали
внутр: внутри
жд: жд
наушник: наушники
выпуст: выпустить
ближайш: ближайшее
свеж: свежих
патент: патентов
проект: проекте проектах проекты
автомобил: автомобиля
рассказ: рассказ
поездк: поездку
кук: кука
кита: китай
событ: событий
погна: погнали
перейт: перейти
объяснен: объяснение
терминолог: терминологии терминологию
процессор: процессоры процессора процессор процессорами
новичок: новичок
экосистем: экосистеме
счита: считайте
кратк: кратким
введен: введением
могл: могли могло
видет: видеть
понима: понимаете
конц: конца конце
семейств: семейство
набор: набором
упрощ: упрощ
нных: нных
команд: команд
режим: режимами
адресац: адресации
обработк: обработка
дан: данных данные данный данной
выполня: выполняется
регистров: регистровыми
операнд: операндами
противн: противном
случа: случае
использ: используются используют используется
загрузк: загрузки
сохранен: сохранения
перемещен: перемещения
регистр: регистры
британск: британская
занима: занимающаяся
устаревш: устаревшая
аббревиатур: аббревиатура
увид: увидим
переименовыва: переименовывают
аппаратн: аппаратные
микроскоп: микроскопом
обнаружен: обнаружение
информацион: информационная информационной
безопасн: безопасность безопасности
дисклеймер: дисклеймер
сообществ: сообществе
техническ: технических технический техническая
специалист: специалистов
ид: ид
дискусс: дискуссия
внедрен: внедрения
троян: троянов
коммерческ: коммерческие
микросхем: микросхемы
сожален: сожалению
чист: чисто
вопрос: вопрос
вмешива: вмешиваются
политическ: политические
аргумент: аргументы
мол: мол
дава: давайте
переход: переходить
российск: российские российской
западн: западных
чип: чипах чипа чипы чипов
типичн: типичный
см: см
контрпропаганд: контрпропаганду
кстат: кстати
американск: американские
китайск: китайских китайского
микрочип: микрочипов
похож: похоже
политик: политики
люб: любят любом
пугалк: пугалки
принят: принятия
выгодн: выгодных
решен: решений решению решение
искусств: искусство
древн: древнее древних
человечеств: человечества
хот: хотим
подчеркнут: подчеркнуть
исследу: исследуем
тем: тему
исключительн: исключительно
общемиров: общемировом
контекст: контексте
важн: важную
област: область
микроэлектроник: микроэлектроники
факт: факты
ангажирова: ангажированные
представител: представители
индустр: индустрии
пуст: пусть
останет: останется
совест: совести
ноутбук: ноутбука ноутбуки
дюймов: дюймовым
экран: экраном
предыстор: предыстория
далек: далеком
мир: миру
карма: карманный
совместим: совместимый
представля: представлял представляет
част: частой часть
мгц: мгц
оснащен: оснащенное
кб: кб
оз: озу
пзу: пзу
комплектова: комплектовался
монохромн: монохромным
диспле: дисплеем
подсветк: подсветки
разрешен: разрешением
пиксел: пикселей
скромн: скромные
мерк: меркам
характеристик: характеристики характеристиках
вышедш: вышедший
имел: имел
борт: борту
битн: битный
частот: частотой
мб: мб
остав: оставил
след: след следующей
будуч: будучи
родоначальник: родоначальником
класс: класса
сверхкомпактн: сверхкомпактный
засвет: засветившись
фильм: фильме
терминатор: терминатор
судн: судный
применя: применяется
джон: джоном
коннор: коннором
взлом: взлома
банкомат: банкомата
доступ: доступа
хранилищ: хранилище
жны: жный
носител: носителей носители
хранен: хранение хранения
приветств: приветствую
дума: думаю
вплот: вплоть
середин: середины
нулев: нулевых
основн: основным основные
средств: средством
перенос: переноса
служ: служили
дискет: дискеты
разумеет: разумеется
нетрудн: нетрудно
догада: догадаться
помим: помимо
распростра: распростран
нны: нные нный
чрезвычайн: чрезвычайно
жным: жными
напрот: напротив
станов: становились становится
худш: худшим
случ: случиться
итак: итак
сегодняшн: сегодняшней
крут: крутых
магнитооптическ: магнитооптических
диск: дисках
разбер: разбер
мся: мся
устро: устроены
каков: каковы
использован: использовании использования
традицион: традиционно традиционный
сервер: сервер сервером
настройк: настройка
накопител: накопители
умн: умный
кейс: кейс
потихоньк: потихоньку
приш: приш
л: л
точн: точнее точного
иде: идея
школьн: школьных
врем: врем
н: н
реализова: реализовать
получ: получилось получим получить получили
хотел: хотел
подел: поделиться
читател: читателями
ко: ко
написа: написанным
гот: готов
оп: опыт
интерес: интересен
велк: велком
заинтересова: заинтересовало
знакомств: знакомство
дифференциальн: дифференциальными
пар: парами
опиш: опишу
принцип: принципы принцип
собствен: собственных собственные
поначал: поначалу
пуга: пугать
достаточн: достаточно
эксперимент: экспериментов
вполн: вполне
пригод: пригоден
применен: применения
рамк: рамках рамки
хобб: хобби
определ: определ
момент: момент
может: можете
реш: решить
микросх: микросхему
задействова: задействовать
подключен: подключение
готов: готовым
извлека: извлекаем
фотограф: фотографии фотографий
программирован: программирование
реверс: реверс
инжиниринг: инжиниринг
привет: привет
маленьк: маленький
быстр: быстрый
восстановлен: восстановлению
начн: начн
изобража: изображающих
металлическ: металлическими
соединен: соединениями
выход: выходе выхода
файл: файл
дизассемблирова: дизассемблировать
эмулирова: эмулировать
подход: подходит подхода
поскольк: поскольку
называ: называемая называть
постоя: постоянная
программируем: программируемая
перемычк: перемычками
означа: означает
отдельн: отдельные
бит: биты
кодир: кодируются
сло: слоями
считыва: считывать
поверхн: поверхности
невелик: невелика
поэт: поэтому
смог: смог
репозитор: репозиторий
сэконом: сэкономив
недел: недели неделю
потрат: потратить
исправлен: исправление
мелк: мелких
побитов: побитовых
ошибок: ошибок
ноксвилл: ноксвилла
трэвис: трэвис
гудспид: гудспид
очередн: очередной очередного
прошл: прошлую
ч: ч
станут: станут
фантастическ: фантастически
тонк: тонкими
кнопк: кнопки
сенсорн: сенсорными
откроет: откроется
магазин: магазин магазине
способ: способом
консультац: консультацию
онлайн: онлайн
концепт: концепт
систем: системы
дат: дата
релиз: релиз
немецк: немецкая
библ: библия
уда: удалось
откопа: откопать
испанск: испанской
барахолк: барахолке барахолку
погод: погода
валенс: валенсии
хорош: хорошая
надолг: надолго
воскресен: воскресенье
отправ: отправился
любим: любимую
писа: писал писали
несмотр: несмотря
быва: бываю
практическ: практически
попада: попадаются
вещ: вещи вещей
встрет: встретиться
блошин: блошином
рынк: рынке
исключен: исключение
понрав: понравиться
раздел: раздел разделы
вмест: вместе
пыта: пытаемся
угада: угадать
предназначен: предназначение
некотор: некоторых
приспособлен: приспособлений
поеха: поехали
протокол: протокол
настро: настроили
получен: получение
сообщен: сообщений сообщение
успешн: успешно
оповещен: оповещение
бп: бп
спецификац: спецификации
спарс: спарсим
создад: создадим
застав: заставит
пода: подать
максимальн: максимально
напряжен: напряжение
реальн: реального
одноплатн: одноплатном одноплатного
пример: примере примером
аналог: аналоге аналогу
интернет: интернета интернет
посвящ: посвящена
задач: задачи задачу
добавлен: добавления
широк: широко
доступн: доступных
модул: модулей модули
реализац: реализации
алгоритм: алгоритму алгоритмы
работ: работы работу
явля: является
скор: скорее
демонстрир: демонстрирующим
общ: общий
опир: опираясь
материа: материал
использу: используя
одноплатник: одноплатники одноплатника одноплатник
продемонстриру: продемонстрируем
наш: нашем
альтернатив: альтернативе
импортозамеща: импортозамещающему
выключен: выключении
сбрасыва: сбрасывается
включен: включении
подсоединен: подсоединении
сет: сети
устанавлива: устанавливается
синхронизац: синхронизацией
обеспеч: обеспечить
закрыт: закрытость
независим: независимость
внешн: внешнего
сервис: сервиса
пущ: пуще
автономн: автономную
налич: наличие
критическ: критически
необходим: необходимым
строг: строго
говор: говоря
используем: используемый
имеет: имеет
встроен: встроенные встроенного
разработчик: разработчики
предусмотрел: предусмотрели
слот: слота
батарейк: батарейки
ограничен: ограниченности
мест: места
плат: плате
репк: репки
продолжа: продолжает
текущ: текущие текущая
перспектив: перспективы
проблем: проблемы
исследован: исследования
прогноз: прогнозы
наход: находится
санкц: санкциями
сша: сша
нм: нм
отказа: отказали
партнер: партнеры
производ: производить
оказа: оказалось
негд: негде
план: планах
восстанов: восстановить
частност: частности
ясн: ясно
поколен: поколения
разрядн: разрядный
микрокомпьютер: микрокомпьютер
полност: полностью
микроконтроллер: микроконтроллер
построен: построенный
слов: слову
техник: техники
век: века
цен: цена
инженерн: инженерного
чуд: чуда
евр: евро
сюд: сюда
вклад: вклад
аккаунт: аккаунт
войт: войти
регистрац: регистрация
публикац: публикации
хаб: хабы
песочниц: песочница
информац: информация
сайт: сайта
документ: документы
соглашен: соглашение
конфиденциальн: конфиденциальность
услуг: услуги
корпоративн: корпоративный
медийн: медийная
реклам: реклама
нативн: нативные
образовательн: образовательные
программ: программы
стартап: стартапам
мегапроект: мегапроекты
яндекс: яндекс
дзен: дзен
язык: языка
вернут: вернуться
верс: версию
rss: rss
greiv: greiv
selectel: selectel
bright: bright
translat: translate
pcie: pcie
ruvd: ruvds
dii: diy
cloud: cloud
y: y
itdog: itdog
openwrt: openwrt
nix: nix
arm: arm
usb: usb
linux: linux
systemd: systemd
ru: ru
vd: vds
wi: wi
fi: fi
ax: ax
monrev: monreve
aaplpro: aaplpro
appl: apple
pro: pro
weekli: weekly
new: news
io: ios
watcho: watchos
maco: macos
iphon: iphone
patientzero: patientzero
armv: armv
aarch: aarch
reduc: a
instruct: reduced
set: instruction
architectur: set
risc: architecture
limit: risc
acorn: limited
machin: acorn advanced
advanc: machine
alizar: machines
fud: alizar
yuriparfenov: fud
gpd: yuriparfenov
pocket: gpd
fydeo: pocket
atari: fydeos
ibm: atari
pc: ibm
portfolio: pc
c: portfolio
lcd: c
x: lcd
macintosh: x
portabl: macintosh
cyberdyn: portable
system: cyberdyne
mafranc: systems
timeweb: mafrance
ryder: timeweb
pci: ryder
express: pci
raspberri: express
pi: raspberry
comput: pi
modul: compute
sivchenko: module
gameboi: sivchenko
mask: gameboy
rom: mask
nintendo: rom
github: nintendo
chatgpt: github
siri: chatgpt
store: siri
ipad: store
droman: ipad
ds: droman
hp: ds
elitedesk: hp
g: elitedesk
pd: g
fusb: pd
ryabova: fusb
rtc: ryabova
real: rtc
time: real
clock: time
repka: clock
allwinn: repka
h: allwinner
huawei: h
tsmc: huawei
gnomebi: tsmc
agon: gnomeby
light: agon
opensourc: light
mark: opensource
tylerskald: marks
alexeynadezhin: tylerskald
kingston: alexeynadezhin
technolog: kingston
seleditor: technology
mordatyj: seleditor
saul: mordatyj
zakhar: saul
facebook: zakhars
twitter: facebook
vk: twitter
telegram: vk
youtub: telegram
habr: youtube
