хабр: хабр
откр: открыть челнах
список: список
стат: стать статьи статей статье взаимодействуете
автор: автором авторы сайта
поток: потоки потока
разработк: разработка разработкой модель подходы
администрирован: администрирование
дизайн: дизайн
менеджмент: менеджмент
маркетинг: маркетинг
научпоп: научпоп
поиск: поиск
профил: профиль
обнов: обновить
новост: новости главной
хаб: хабы
компан: компании авторов
подряд: подряд
скопирова: скопировать
ссылк: ссылку
показыва: показывать
нов: новые новую нового новых познакомиться выпустили
лучш: лучшие
порог: порог
рейтинг: рейтинга рейтинг
уровен: уровень
сложност: сложности
прост: простой простая простое
средн: средний
сложн: сложный сложного сложных сложной
примен: применить
минут: минут минуты
лабораторн: лабораторный лабораторное
таймер: таймер таймера
импортозамещен: импортозамещение
подручн: подручных
материал: материалов
прочтен: прочтение
мин: мин
количеств: количество количества
просмотр: просмотров
программирован: программирование программированием
микроконтроллер: микроконтроллеров
развит: развитие развитием развитию создания
стартап: стартапа стартапов стартапами предпринимателей
нанотехнолог: нанотехнологии
понадоб: понадобился
программируем: программируемый
рел: реле
штуковин: штуковина
указа: указанное проходить маркеры
замыка: замыкает
контакт: контакты
одн: одним одному собрать
слов: словом
начал: началом
санкц: санкций
оборудован: оборудование
куп: купить
стал: стало
невозможн: невозможно
хорош: хороший хорошие
пример: пример примеру полно
отличн: отличное
устройств: устройство неисправности
прям: прямо
пишет: пишет
продавец: продавец
случа: случай ответить
удобн: удобная
привлекательн: привлекательная
предыдущ: предыдущий
вариант: вариант
налич: наличии
сто: стоит
непотребн: непотребно
задач: задачи рутинных
достаточн: достаточно
обычн: обычного
совмеща: совмещает
нездоров: нездоровую нездоровые
цен: цену
срок: сроки
поставк: поставки
чита: читать
дал: далее накинули
голос: голосов
добав: добавить
закладк: закладки
комментар: комментарии
хакер: хакер
сам: самые самых
безопасн: безопасности безопасность
март: март марта
блог: блог нашего
журна: журнал
информацион: информационная информационной государственных
дайджест: дайджест
ежедневн: ежедневно
публик: публикуются
актуальн: актуальные
конц: конце обещают
кажд: каждого ходе
месяц: месяца месяце
подвод: подводим
итог: итоги
представл: представлен
дистрибут: дистрибутив
учен: ученые
эксперт: эксперты
призыва: призывают
приостанов: приостановить
обучен: обучение обучения
и: ии
правоохранител: правоохранители
арестова: арестовали
создател: создателя
дрон: дроны
раскрыва: раскрывают
местоположен: местоположение
оператор: операторов
ищет: ищет
человек: человека человеком
слил: слил
исходн: исходные исходным
код: коды коду кодом практика
выявл: выявлены
опасн: опасные
уязвим: уязвимости
интересн: интересные
событ: события
час: часов
рев: ревью
программистск: программистском
тестирован: тестирование тестирования
сист: систем
мобильн: мобильных командой
приложен: приложений приложения
управлен: управление государственного
песочниц: песочницы публикации
собеседован: собеседовании собеседования
тестировщик: тестировщиков
зада: задаю
вопрос: вопрос вопросе
дела: делают делается делать
команд: команде команда увеличили прошлом
слыш: слышу
ответ: ответ ответила навсегда
разн: разные разных
вариац: вариации
разработчик: разработчики разработчикам разработчиков разработчиком
вника: вникал
обща: общаемся
никт: никто
знает: знает
питон: питон
тест: тесты тест
написа: написаны написала
н: н
неужел: неужели
подход: подходит подходам гибкие
дава: давайте
начн: начнем
ручн: ручного
над: надеюсь
ник: никого
удивл: удивлю
относ: относится
слыша: слышали
аналитик: аналитики группы нужен аналитик
прототип: прототипов
кейс: кейсов устроено
внедря: внедряли
работа: работают рассказывает наставников разработчицей часть
специалист: специалисты специалистов
б: б
аг: ага
вс: вс
полезн: полезными подборку
встреч: встречами
понима: понимаю данной
искрен: искренне
счита: считаю считается считают
обо: обоих
пункт: пунктах
происход: происходит
рационализац: рационализация
страх: страха
страшн: страшно
работ: работу работы работа гост
друг: другим другими
обнаруж: обнаружить
пробел: пробелы
знан: знаниях
проигра: проиграть
сравнен: сравнении
узна: узнали
помощ: помощь помощью
культур: культура
рад: радья
перлма: перлман
мат: мать
интернет: интернета
протокол: протокол протокола протоколов
инфраструктур: инфраструктура
истор: история историю истории
биограф: биографии
гик: гиков
ретроспектив: ретроспектива
миров: мировой
индустр: индустрии
известн: известно известная известна
изобретател: изобретателей
исследовател: исследователей
большинств: большинство пожалуй
мужчин: мужчины
женщин: женщины женщин
наравн: наравне
внос: вносили
вклад: вклад
технолог: технологий технологию
например: например
ад: ада
лавлейс: лавлейс
перв: первую первого
программ: программу образовательные
хед: хеди
ламарр: ламарр
придума: придумавшая
грейс: грейс
хоппер: хоппер
разработа: разработала
компилятор: компилятор
кар: карен
спарк: спарк
продума: продумала
концепц: концепцию
поисков: поисковой
систем: системы системах
знат: знать
существ: существует
сред: среди
хоч: хочу
выдел: выделить
американск: американского
программист: программиста программистами программистов программистом программисты
сетев: сетевого
инженер: инженера
джо: джой
благодар: благодаря
сво: своему своим своем продукт
изобретен: изобретению
связ: связующего
дерев: дерева
усовершенствова: усовершенствованный
использ: используется
компьютерн: компьютерных
сет: сетях
наработк: наработки
легл: легли
основ: основу
передач: передачи
цифров: цифровых цифровой
дан: данных кейс
так: таких такими
плазм: плазма
альтернативн: альтернативной
энергетик: энергетике энергетики
онлайн: онлайн
патент: патент
читальн: читальный
зал: зал
патентован: патентование
энерг: энергия энергию
элемент: элементы
питан: питания
эколог: экология
обзор: обзор
сфер: сфере
экологичн: экологичных
энергетическ: энергетических
упор: упор
прав: правило полочкам
солнц: солнца
ветр: ветра
времен: временем
правительств: правительства
мног: многих многом многие
стран: стран финансы
вкладыва: вкладывают
огромн: огромные
сумм: суммы
контролируем: контролируемого
термоядерн: термоядерного
синтез: синтеза
плазмен: плазменной
четв: четв
ртно: ртное
состоян: состояние
веществ: вещества
могл: могла
использова: использована
проект: проектах проектам позволяющих коммерческом экономики стадии дополнительный помочь нативные
как: какие научились
уда: удалось
воплот: воплотить
недостаточн: недостаточного
нужн: нужных
открыва: открывают
человечеств: человечеством
перспектив: перспективы
форум: форум
карьер: карьера
фон: фоне
больш: большого больших большего концу
вид: вида виды
прошел: прошел
курс: курсы
дне: дней
реш: решил блога
подел: поделиться
опыт: опытом опыте
упорн: упорного
включ: включая
школьн: школьной
вузовск: вузовской
подготовк: подготовки
спрос: спросить
способствова: способствовало
мо: моему направлении
становлен: становлению
назов: назову
вуз: вуз
коллег: коллег
книг: книги топ продакта
нача: начать стране
придет: придется
издалек: издалека
собира: собирать
лог: логи логов
системн: системное
туториа: туториал
перевод: перевод
логирован: логирование
трех: трех
столп: столпов
мониторинг: мониторинга
распределен: распределенных
мож: можем
видет: видеть
бурн: бурное
популярн: популярных становились набирал реально
продукт: продуктов попробовать литература
открыт: открытым открытия
тип: типа
полноцен: полноценных
коммерческ: коммерческих сво
помога: помогают
проблем: проблемами проблемой
протоколирован: протоколирования протоколирование
масштаб: масштабах
оста: остается равно
усугубля: усугубляется
постоя: постоянным постоянно
рост: ростом
объем: объема экономит
внедрен: внедрения
контейнеризац: контейнеризации
рассмотр: рассмотрим
различн: различные
необходим: необходимых
улучшен: улучшения
удел: уделим
вниман: внимание
сбор: сбору сбор
агрегац: агрегации
анализ: анализу
привед: приведем
решен: решение облачных
использован: использованием
сервис: сервисов веб исследования новый
упрост: упростит
футбол: футбол
английск: английский
уч: учить учиться
стив: стивом
джобс: джобсом
школ: школа
диалог: диалог
учебн: учебный
процесс: процесс процессов
образован: образование
рубеж: рубежом
эмиграц: эмиграция
распозна: распознать
чад: чаде
айтишник: айтишника
возможн: возможно
смотрет: смотреть
ребенок: ребенок
определен: определенно
будущ: будущий
ген: гений
дума: думают думает
идт: идти
долж: должен
облада: обладать
желан: желанием желание
алгоритм: алгоритму
крайн: крайней
мер: мере
анекдот: анекдотах
дел: деле
опрос: опросили
наш: наших читателям
преподавател: преподавателей
кафедр: кафедры
разобра: разобраться
расскаж: расскажем гибдд
общ: общих
частн: частных
мнен: мнениях рефакторинг
сошл: сошлись
ключев: ключевым
момент: моментам момента управления спорные
пятиклассник: пятиклассник
игр: играя игры рубились игр
верс: версию
пойт: пойти
пишут: пишут
созда: создают
простеньк: простенькие
понятн: понятно
явн: явно
способн: способности
занима: заниматься
остальн: остальными
иска: искать
либ: либо
специальн: специальные
ребенк: ребенка
обеспеч: обеспечить
выбор: выбор
востребова: востребованной
професс: профессии
токсичн: токсичного токсичные токсичным
сотрудник: сотрудника сотрудники
этап: этапе
персонал: персоналом
принос: приносят
польз: пользу проекту
миф: миф
правд: правда
мил: мила
протасенк: протасенко
руководител: руководитель
талант: талантов
рассказа: рассказала лиги
тестиру: тестируем
формат: форматы форматов форматах крупный
поддержк: поддержки техническая
татарстан: татарстане
трансформац: трансформации
татарста: татарстана республики
венчурн: венчурные
инвестиц: инвестиции
активн: активно полезен
ведет: ведется
казан: казани
ит: ит
парк: парка парк кстати
запуск: запуском
башир: башира
рамеев: рамеева
полгод: полгода
продолж: продолжилось
рассказыва: рассказываем татарстан
тестирова: тестировал
различ: различия
рабоч: рабочих тратить
взаимодейству: ним
бизнес: взаимодействуем
инкубатор: бизнес
крупн: инкубатор
запущен: формат
стен: запущенный
площад: стенах
тыс: площади
кв: тыс
кстат: кв
набережн: парке
челн: набережных
сраз: открылся
универсальн: сразу
площадк: универсальная
предпринимател: площадка
предоставля: стартапам
комплекс: предоставляется
услуг: комплекс конфиденциальность
ресурс: услуг
мест: ресурсов одном
бухгалтерск: мест
обслуживан: бухгалтерского
позволя: обслуживания
меньш: проектом
затрат: меньшими
блогер: затратами
станов: блогеры
дневничк: популярными
жж: дневничкам
набира: жж
айфон: популярность
смартфон: айфоны
сенсорн: смартфоны
экран: сенсорными
начина: экранами библиотеке грусть
захватыва: начинали
мир: захватывать
главн: мир айпады
цифровизац: новостью
государствен: цифровизации работе вывода
депутат: момент
госдум: депутатам
разда: госдумы
айпад: раздали
кринж: главным
заседан: кринжем
руб: заседаниях
реальн: игра
вернут: популярной поддержка
деньг: вернуть
техническ: деньги языка
товар: технически
ненадлежа: товар
качеств: ненадлежащего
законодательств: качества зрения
гаджет: законодательство
привет: гаджеты
тем: привет
возврат: тема
денежн: возврата
средств: денежных
приобретен: средств
поднима: приобретенный
ран: поднималась
положен: ранее
законодательн: положения
акт: законодательных
судебн: актов
позиц: судебные
склон: позиции
меня: склонны
читател: меняться активным
собра: читателей грабли
правов: месте
норм: правовые
разлож: нормы
полочк: разложить
покупател: права
обязан: покупателя
продавц: обязанности
объясн: продавца
точк: объяснить
зрен: точки
осуществлен: законодательства
заодн: осуществления
навсегд: заодно
обнаружен: случае
неисправн: обнаружение
фиксирова: устройства
совершен: фиксировать моменты
действ: совершенные выпуска
личн: действия ид
кабинет: личный личном
заметк: кабинет
предлага: заметке
познаком: предлагаем
веб: новым
реч: сервисом
ид: речь
пользовател: кабинете
полез: пользователя
попробова: решит рассказал
быстр: проекте
создава: быстро
гостов: создавали
тз: гостовому
облегч: тз
госзаказчик: облегчило
лиг: госзаказчиком решений
экономик: лига
миха: проектами
михайлец: михаил
групп: михайлец
направлен: аналитиков стажировок
облачн: направления
подготов: попробовала
классическ: подготовить
гост: классическому действующих
заказчик: государственным ещ
получ: заказчиком
пожал: получилось
предусматрива: большинству
водопадн: предусматривает
модел: водопадную самозанятых
недавн: разработки
зафиксирова: недавнего
постановлен: зафиксирована
российск: постановлении
федерац: российской
июл: федерации
требован: июля
порядк: требованиях
создан: порядку учитывались
ввод: развития
эксплуатац: ввода эксплуатацию
вывод: эксплуатации
дальн: информационных
хранен: дальнейшего
содержа: хранения
баз: содержащейся
информац: базах песочница
несмотр: информации
обнадежива: несмотря
движен: обнадеживающее
сторон: движение итеративной
итеративн: сторону
стандарт: стороны
обновля: стандарты
спешат: обновляться
год: спешат
выпуск: годы
идут: гостов
тир: идут
номер: тире
тонк: номерах
намека: тонко
гибк: намекают
учитыва: разработке интересы
теор: создании
пород: теории
жизнеспособн: породить
кентавр: жизнеспособного
течен: кентавра
спринт: течение
проход: спринтов
стад: указанные
раз: проекта
ход: разом
функц: каждой
топ: функции
продакт: книг опытного
менеджер: продакт содержание
профессиональн: менеджера
литератур: профессиональная
почита: продуктом
состав: почитать
подборк: составил
должн: полезных
библиотек: должны
опытн: начинающего
прикреп: книге
кратк: прикрепил
содержан: краткое
поня: менеджеру
нуж: понять
макс: аналитика
павл: максим
управля: павлов
партнер: управляющий
типов: партнер
ситуац: типовая
шла: ситуация
увелич: шла
накинул: команду
дополнительн: дали
появ: проект
ещ: появился
интерес: заказчик
постепен: учитывать
радост: постепенно
сменя: радость
груст: сменяется
ухудша: начинает
расписа: ухудшаться
маркер: расписал
зват: указать
роботизирова: звать понимать
автоматизац: роботизированная роботизированную применяется
орган: автоматизация
власт: органах
устро: власти
роботизац: автоматизацию
применя: роботизация работающие
рутин: автоматизации
выполня: задач
четк: выполняемых
инструкц: четкой
центр: инструкции
республик: центр работает
госучрежден: республике
внедр: госучреждения
робот: внедрили
эконом: роботов
обработа: объемы
перенес: обработаны
навред: перенесены
деликатн: навреди
совет: деликатные статья
наставник: советы рами руководством скажу
новичк: работающих
зовут: новичками
ольг: зовут
болотов: ольга
представля: болотова
фронтенд: представляю
разработчиц: фронтенд
стаж: работала
рам: стаж
руководительниц: наставниками
запуст: руководительницы
стажировок: запустила
прошл: моей прогнозы
зна: прошлой
ры: знаю
обернут: ры
бол: обернуться
потеря: болью
бриллиант: потерянным
руководств: бриллиантами
стрем: наставника
ограня: стремилась
алмаз: огранять
трат: алмазы
остава: рабочий
профессионал: оставаться
перегиба: профессионалом
палк: перегибать
выпуска: палку
мотивирова: выпускать
зака: мотивированных
нных: закал
уверен: нных
ложн: уверенных
скромност: ложной
скаж: скромности
готов: наставник
взаимодействует: готовитесь
мастхэв: советами
кредитован: мастхэв
самозанят: кредитование
финанс: модели
составля: начало
важн: составляет
граждан: важно
рф: граждане
обеща: рф
подавля: большое
част: подавляющая
исследован: применяли
европротокол: сервиса
ртлабс: европротокол
прогноз: ртлабс
госуслуг: мобильного
авт: госуслуги
выпуст: авто
оформлен: сервис
дтп: оформление
участ: дтп
инспектор: участия
гибдд: инспектора
разрабатыва: расскажу
грабл: разрабатывали
науч: собрали
результат: каких
достигл: результатов
практик: достигли
спорн: код
проектирован: совершенный
рефакторинг: проектирование
сказа: мнение
равн: сказано
поспор: остаются
обсужда: поспорить
внутрен: обсуждали
посиделок: внутренних
панаце: посиделок
постро: панацея
помоч: построить
гарантирова: польза
полн: гарантирована
котор: примеров
идет: которым
вред: идет
поговор: вред
скрыва: поговорим
подводн: скрываются
провест: подводные
сюд: провести
аккаунт: сюда
войт: аккаунт
регистрац: войти
раздел: регистрация
публикац: разделы
сайт: информация
документ: компаний
соглашен: документы
конфиденциальн: соглашение
корпоративн: услуги
медийн: корпоративный
реклам: медийная
нативн: реклама
образовательн: проекты
мегапроект: программы
яндекс: мегапроекты
дзен: яндекс
настройк: дзен
язык: настройка
стар: вернуться
rss: rss
aleaksah: aleaksah
assembl: assembler
http: http https
www: www
optimum: optimum
lab: lab
ru: ru
product: product
tajmer: tajmer
laboratornyj: laboratornyj
chipdip: chipdip
n: n
ac: ac
dc: dc
pand: pand
xakep: xakep
kali: kali
purpl: purple
breachforum: breachforums
dji: dji
twitter: twitter
github: github
tpm: tpm
scarethebear: scarethebear
shift: shift
left: left
darya: darya
chuyko: chuyko
stp: stp
serverspac: serverspace
wi: wi
fi: fi
span: spanning
tree: tree
protocol: protocol
trill: trill
sokolovp: sokolovps
arezvov: arezvov
forum: forum
vingrad: vingrad
sovasova: sovasova
fluentd: fluentd
fluent: fluent
bit: bit
southbridg: southbridge
devop: devops
kubernet: kubernetes
elk: elk
stack: stack
splunk: splunk
open: open
sourc: source
lesallaydialog: lesallaydialog
le: le
sallai: sallay
stem: stem
yooteam: yooteam
digitaltatarstan: digitaltatarstan
angri: angry
bird: birds
vasjen: vasjen
staticoldrecurs: staticoldrecursion
pv: pvs
studio: studio
digit: digital
leagu: league
jira: jira
atlassian: atlassian
visual: visual
basic: basic
applic: applications
powerlift: powerlifter
manag: manager
uwrit: uwriter
kt: kts
rpa: rpa
olbol: olbol
qiwi: qiwi
develop: developer
advoc: advocate
c: c
dymov: dymov
alex: alex
tenerifepearl: tenerifepearl
maxilect: maxilect
facebook: facebook
vk: vk
telegram: telegram
youtub: youtube
habr: habr
