хабр: хабр
откр: открыть откры
список: список
стат: стать статьи статья статье статей
автор: автором авторы автора автор авторов
поток: потоки
разработк: разработка разработке разработки
администрирован: администрирование администрирования
дизайн: дизайн
менеджмент: менеджмент
маркетинг: маркетинг
научпоп: научпоп
поиск: поиск поиском поиска
профил: профиль
обнов: обновить
рейтинг: рейтинг рейтинга
информацион: информационная информационной информационных
безопасн: безопасность безопасности безопасного безопасной
защит: защита
дан: данных данной данная данные данным
компан: компании компаниях компания компаний
подряд: подряд
скопирова: скопировать
ссылк: ссылку
показыва: показывать
нов: новые
лучш: лучшие лучший лучших
порог: порог
уровен: уровень
сложност: сложности
прост: простой
средн: средний
сложн: сложный
примен: применить
минут: минуты
хакер: хакер
сам: самые самых самая самым
новост: новости
март: март марта марте
прочтен: прочтение
мин: мин
количеств: количество количества
просмотр: просмотров
блог: блог блога
журна: журнал
дайджест: дайджест
ежедневн: ежедневно
публик: публикуются
актуальн: актуальные
конц: конце
кажд: каждого каждой каждом
месяц: месяца месяце
подвод: подводим
итог: итоги
представл: представлен
дистрибут: дистрибутив
учен: ученые
эксперт: эксперты
призыва: призывают
приостанов: приостановить
обучен: обучение
и: ии
правоохранител: правоохранители
арестова: арестовали
создател: создателя
дрон: дроны
раскрыва: раскрывают раскрывающая
местоположен: местоположение
оператор: операторов
ищет: ищет
человек: человека
слил: слил
исходн: исходные
код: коды код
выявл: выявлены
опасн: опасные опасность
уязвим: уязвимости уязвимой уязвимость уязвимостям уязвимостей
интересн: интересные интересной интересными
событ: события событиями
чита: читать
дал: далее
добав: добавить
закладк: закладки
комментар: комментарии
час: часа часов
краж: кража
учетн: учетных
администратор: администратора
касан: касания
помощ: помощью
пут: путем пути
злоупотреблен: злоупотребления
песочниц: песочницы песочница
перевод: перевод переводят
скомпрометирова: скомпрометировали
хост: хост хостах
может: можете
хот: хотите
дела: делать делай делал делает
дамп: дамп
открыт: открытых открытом открытый открытое
парол: паролей пароли паролем
традицион: традиционных
метод: методов методам
след: следует
провер: проверить
настройк: настройки настройка
делегирован: делегирования
включ: включен включая
позволя: позволяет позволял
получа: получать
вид: виде
затрагив: затрагивая
процесс: процесс процессы
име: имея
прав: прав правило права
ограничен: ограниченного ограниченный ограниченным ограниченных
текущ: текущего
пользовател: пользователя пользователей пользователю
подробн: подробный подробного подробно подробнее подробности
разбор: разбор
решен: решения
машин: машины машинное
изуча: изучаем изучает изучать
язык: язык языка
запрос: запросов запросы
программ: программы программе
туториа: туториал туториала
втор: вторая
перв: первая первой первого
выполнен: выполнения
задач: задач задачи
наверн: наверное
знает: знаете знает
неплох: неплохой
инструмент: инструмент инструментов инструменты
сбор: сбора сбор
информац: информации информацию информаци информация
конечн: конечных
устройств: устройств устройство
ключев: ключевым
элемент: элементом
явля: является
собствен: собственный собственных
называ: называется
специфическ: специфический
спрос: спросите
причин: причины причине причин
подход: подход подходить
доб: добиться
необходим: необходимой необходимую необходимостью
гибкост: гибкости
адаптац: адаптации
меня: меняющихся меняет
требован: требований
познакомл: познакомлю
базов: базовыми базовым
понят: понятиями понятие понятием
структур: структурой структурами
стара: стараться
подкреп: подкрепить
теоретическ: теоретическую
част: часть части
пример: примерами примере
получен: полученных получения получение полученные
знан: знаний знанием
достаточн: достаточно
чувствова: чувствовать
комфортн: комфортно
изменен: изменении изменения
существ: существующих существует существующие
создан: создании
истор: истории
бэкап: бэкапа бэкапы
полезн: полезные полезной полезных
совет: советы
резервн: резервное резервного резервные
копирован: копирование копирования
хранен: хранение
хранилищ: хранилища
инициатив: инициативе
вс: вс
мир: мире
отмеча: отмечают
способ: способ способы способами способов
отмет: отметить
праздник: праздник
созда: создать
коп: копии
протестирова: протестировать
голос: голосов
дуалистическ: дуалистическая
природ: природа
скрыт: скрытых скрытого
параметр: параметров
заголовк: заголовков
продолжа: продолжаем
сер: серию
расширен: расширения расширении
начальн: начального
этап: этапа этапе
пентест: пентеста
веб: веб
приложен: приложения приложении приложение
определен: определение
больш: большего большие
точек: точек
взаимодейств: взаимодействия
числ: числе числа
файл: файлов файла файл
директор: директорий
эндпоинт: эндпоинтов
начина: начинающего начинающих начинаем
пентестер: пентестера
представля: представляет
трудност: трудностей
освоен: освоении
дел: дело
обсто: обстоит
сторон: стороны сторону
концептуальн: концептуально
нич: ничем
отлича: отличается
перебор: перебора
реч: речь
пойдет: пойдет
мног: многие многих
например: например
авторств: авторством
джеймс: джеймса
кеттл: кеттла
имеет: имеет
документац: документации документация
правд: правда
никит: никиты
ступин: ступина
назначен: назначения
настроек: настроек
попроб: попробую
углуб: углубиться
маленьк: маленьких
опытн: опытных
добр: доброго добры добрый
дня: дня
коллег: коллеги
дава: давайте
поговор: поговорим поговорить
смысл: смысла
аббревиатур: аббревиатуре
направлен: направление
котор: которое которым
поможет: поможет
эффективн: эффективно
получ: получить получили
объект: объекте
исследован: исследования исследований
отрезок: отрезок
возможн: возможно возможные
точн: точно
цитир: цитирую
википед: википедию
дка: дка
тым: тым
ист: исто
чник: чникам
англ: англ
разведывательн: разведывательная разведывательной разведывательном разведывательных
дисциплин: дисциплина
включа: включающая
выбор: выбор
общедоступн: общедоступных общедоступность
источник: источников источник источника
анализ: анализ анализа
сообществ: сообществе
термин: термин
указыва: указывает
отлич: отличие отличить
секретн: секретных секретным секретная
использован: использованием использования
связа: связан связанных связано связанные
означа: означающий
люб: любую любые
находя: находящуюся находящийся
пространств: пространстве
сми: сми
тождествен: тождественно
публичн: публичной публично
разведк: разведке
сто: стоит стоят
пута: путать
программн: программное
обеспечен: обеспечение
уч: учить
треб: требуется
индивидуальн: индивидуально
кулинар: кулинария
повар: повара
сво: свой своим
рецепт: рецепт
покаж: покажу
помогут: помогут
поня: понять
как: какую какие
двига: двигаться
достижен: достижения достижений
результат: результата
помоч: помочь
тем: тема
покажет: покажется
будьт: будьте
напиш: напишите напишу
ряд: ряд ряду
тематик: тематике
прош: прошу
учитыва: учитывать
неопытн: неопытных
специалист: специалистов специалистам специалисты специалист
мар: мар
шут: шути
хайпов: хайповая
нейросет: нейросеть нейросети
применя: применяться применять применяют
кибератак: кибератаках
измен: изменить изменит
иб: иб
лаборатор: лаборатория лаборатории
касперск: касперского
программирован: программирование
искусствен: искусственный искусственного
интеллект: интеллект интеллекта
пожал: пожалуй
набалова: набаловались
пришл: пришла пришлось
максимальн: максимально
серьезн: серьезно
технолог: технологии технологий
влия: влияют
сфер: сферы сфере
наш: нашей нашу
жизн: жизни
кибербезопасн: кибербезопасность
целев: целевых целевыми
атак: атак атаки атакующими атаками
компрометац: компрометации
помога: помогать
детектирован: детектировании детектирования
угроз: угроз
пользова: пользоваться
син: синие
красн: красные
картинк: картинка
сдела: сделана
совместн: совместной
тимлид: тимлида
владисла: владислав
тушкан: тушканов
виктор: виктор
серге: сергеев
покажут: покажут
способн: способна
подсказа: подсказать
злоумышленник: злоумышленникам злоумышленнику злоумышленник
сможет: сможет
рассказа: рассказать
отрасл: отрасль
начал: начале
принтер: принтер принтера
привилег: привилегии привилегий привилегию
дом: домена
нача: начав
инфосистем: инфосистемы
джет: джет
прошл: прошлом прошло
команд: командой
реш: решили
подел: поделиться поделимся
нескольк: несколькими
вектор: векторами
отзыв: отзывам отзывами отзывы
оказа: оказалась оказались
наста: настало
продолж: продолжить
пост: посте пост
расскаж: расскажу расскажем
доступ: доступа доступ доступен
панел: панели
привест: привести
эксплуатац: эксплуатации
неограничен: неограниченного
дополн: дополнили
рекомендац: рекомендациями
мониторинг: мониторингу
случа: случай случаях
монитор: мониторить
ваш: вашем
кратк: краткое
описан: описание
схем: схеме
кат: катом
главн: главных главное главным
киберугроз: киберугрозах киберугрозы киберугроз
массов: массовые
утечк: утечки утечкам утечке
взлет: взлет
популярн: популярности популярным популярных популярны
вайпер: вайперов
межотраслев: межотраслевые межотраслевых
последств: последствия последствий
прогноз: прогнозы
криптовалют: криптовалюты
аналитик: аналитика аналитик
проанализирова: проанализировали
общ: общее
инцидент: инцидентов инцидентами инциденты
увелич: увеличилось
сравнен: сравнению
год: годом
одн: одними одна одном
тенденц: тенденций
стал: стали стало
увеличен: увеличение
ресурс: ресурсами
появлен: появление
усилен: усиление
зашифрова: зашифрованные
атакова: атаковали атаковал
российск: российский российских
бизнес: бизнес
голов: головой голове
погруз: погрузиться
изучен: изучение
матриц: матрицы
используем: используемых
тактик: тактик
техник: техник
процедур: процедур
ответ: ответим
вопрос: вопрос вопросы
практическ: практически
все: всей
хакерск: хакерской
активн: активности
сталкива: сталкивались
компьютерн: компьютерной
криминалистик: криминалистики
реагирован: реагирований
финансов: финансовый финансовых
сектор: сектор
тип: типом
верн: верно
вымогател: вымогатели
обзор: обзор
организац: организация организации организациям
кластер: кластеров кластеру
системн: системное
платформ: платформа платформы
сист: систем
оркестрац: оркестрации
контейнер: контейнеров
времен: временем
полност: полностью
инфраструктур: инфраструктуру инфраструктура
проект: проекты
рельс: рельсы
возника: возникают
контрол: контроля
умолчан: умолчанию
подключ: подключиться
стандартн: стандартного
конфигурацион: конфигурационного
имен: именем
пробл: проблем
продукт: продукт продукты продуктами
назван: названием название
обнаружен: обнаружение обнаружения
привет: привет
алекс: алексей
исследовател: исследователь
рассмотр: рассмотрим
критичн: критичные
ядр: ядра ядро ядру
выход: выходят выхода
несут: несут
особ: особую
затрагива: затрагивают
сраз: сразу
множеств: множество
дистрибутив: дистрибутивов дистрибутивах
работа: работающие
верс: версии версиях версию
зачаст: зачастую
проэксплуатирова: проэксплуатированы
сред: сред
настро: настроены
дополнительн: дополнительные
политик: политики
устранен: устранения
нест: нести
пор: порой
риск: риски
промышлен: промышленных
так: таких
раскрыт: раскрыта
затронул: затронула
начин: начиная
исправл: исправлена
известн: известных
момент: момента
патч: патчей
установл: установлены
основн: основные основными
модул: модулей
цел: целом
друг: другим
непривилегирова: непривилегированному
внос: вносить
чтен: чтения
сут: сути
разн: разными
построен: построении
заостря: заострять
вниман: внимание
эксплуатацион: эксплуатационных
шаг: шагах
обращен: обращения
распозна: распознать
попытк: попытки
бездарн: бездарная
книг: книга книги
криптограф: криптографии криптография криптографией криптографию
доктор: доктора доктором
информатик: информатики
содерж: содержит
ошибок: ошибок
правильн: правильных
сужден: суждений
профессиональн: профессиональная
литератур: литература
появ: появилась
ключ: ключом
фрэнк: фрэнка
рубин: рубина
совр: совру
скаж: скажу
заинтересова: заинтересовала
хорош: хорошими хорошее
таков: таковой
магистр: магистром
математик: математики
занима: занимающимся
крайн: крайней
мер: мере
пишет: пишется
обложк: обложке
вовс: вовсе
куп: купил
прочита: прочитать
отвратительн: отвратительные
написа: написал написать
кустарн: кустарных
услов: условиях
понима: понимающий
шифр: шифр
цезар: цезаря
скор: скорее
факт: факт
держ: держим
послед: последующее
повествован: повествования
связ: связи
следствен: следственный
комитет: комитет
рф: рф
мошенник: мошенникам
уда: удается
обход: обходить
мыслим: мыслимые
немыслим: немыслимые
закон: законы
облачн: облачные облачная
сервис: сервисы сервис сервисов
мнен: мнение
отвеч: отвечая
звонок: звонок
слыша: слышали
ива: иван
иван: иванов
лейтенант: лейтенант
петр: петр
петрович: петрович
управлен: управление
мвд: мвд
служб: служба
центральн: центрального
банк: банка
росс: россии
подставьт: подставьте
зна: знаем
спойлер: спойлеры
последн: последнему последнее
сезон: сезону
игр: игра
престол: престолов
опрос: опроса
национальн: национального национальных
агентств: агентства
ма: мае
июн: июне
россия: россиян
спам: спам
звонк: звонки
техническ: технической техническая
точк: точки
зрен: зрения
спамер: спамерам
удава: удавалось
дозвон: дозвониться
пыта: пытается
забра: забрать
рассказыва: рассказывает
миха: михаил
борис: борисов
внедря: внедряем
сайт: сайтов сайта
олег: олег
казак: казаков
разрабатыва: разрабатываемого
софт: софта
остр: остро
внедрен: внедрение
практик: практик
станов: становится
подготов: подготовили
цикл: цикл
опыт: опытом
наработк: наработками
состо: состоит
внедр: внедрить
теор: теории
взлома: взломали взломан
бот: бот
платежн: платежные
систем: системы
потряса: потрясает
наскольк: насколько
творческ: творчески
использова: использовать
разумеет: разумеется
вредн: вредного
фишинг: фишинг
хищен: хищение
личн: личных
незакон: незаконно
чуж: чужой
удивительн: удивительно
положительн: положительным
образ: образом
создава: создавал
мантр: мантра
звуча: звучала
случ: случилось
плох: плохое
люд: людям
узнава: узнавать
подвергл: подверглись
горазд: гораздо
шир: шире
хотел: хотел
услыша: услышал
н: н
лиц: лица
назов: назову
обрис: обрисую
картин: картину
проблем: проблемы
снайпинг: снайпинга
разработчик: разработчиков разработчика
астр: астра
линукс: линукс
будущ: будущее
крупн: крупный крупнейшими
игрок: игрок
рынк: рынке
производ: производит
отечествен: отечественное
защищен: защищенные
операцион: операционные операционных
виртуализац: виртуализации
вход: входят
реестр: реестр
минкомсвяз: минкомсвязи
использ: используются используется
государствен: государственными
стран: страны
министерств: министерствами
корпорац: корпорациями
член: членом
ассоциац: ассоциации
руссофт: руссофт
арпп: арпп
лауреат: лауреатом
международн: международных
прем: премий
заслуг: заслуг
внушительн: внушительный
стимул: стимулом
детальн: детального
знакомств: знакомства
инъекц: инъекции инъекций инъекция
тестирован: тестирование
переход: переходим
проникновен: проникновение
начн: начнем
внешн: внешнего
вмешива: вмешиваться
баз: базе
просматрива: просматривать
изменя: изменять
удаля: удалять
вызыв: вызывая
постоя: постоянные
содержим: содержимом
поведен: поведении
исследова: исследовать
вредоносн: вредоносный вредоносное
рамк: рамках
работ: работы работа
приход: приходится
уничтожен: уничтожению
защища: защищаемой
происход: происходить
длин: длинного
списк: списка списке
ближ: ближе
топ: топу
наход: находятся
легитимн: легитимного
аспект: аспектов
сюд: сюда
вклад: вклад
ваканс: вакансий вакансии
аккаунт: аккаунт
войт: войти
регистрац: регистрация
раздел: разделы
публикац: публикации
хаб: хабы
документ: документы
соглашен: соглашение
конфиденциальн: конфиденциальность
услуг: услуги
корпоративн: корпоративный
медийн: медийная
реклам: реклама
нативн: нативные
образовательн: образовательные
стартап: стартапам
мегапроект: мегапроекты
яндекс: яндекс
дзен: дзен
поддержк: поддержка
вернут: вернуться
стар: старую
rss: rss
pand: pand
xakep: xakep
ru: ru
kali: kali
purpl: purple
breachforum: breachforums
dji: dji
twitter: twitter
github: github
tpm: tpm
sidneyjob: sidneyjob
lsass: lsass
kekeo: kekeo
credssp: credssp
window: windows
uhahatbl: uhahatbl
tv: tv
writeup: writeup
htb: htb
machin: machine
inject: inject
easi: easy
vitalii: vitaliy
x: x
velociraptor: velociraptor
threat: threat
hant: hanting
dfir: dfir
queri: a
languag: query
vql: language
vd: vql
ruvd: vds
reddit: ruvds
zeropercentangel: reddit
param: zeropercentangel
miner: param
deiterii: miner
lab: deiteriy
burp: lab
suit: burp
black: suite
box: black
turbo: box
intrud: turbo
nikitastupin: intruder
segrei: nikitastupin
osint: segrey
recoveri: osint
mode: recovery
open: mode
sourc: open
intellig: source
inform: intelligence
osif: information
public: osif
softwar: public
kasperski: software
chatgpt: kaspersky
lead: chatgpt
data: lead
scientist: data
incid: scientist
respons: incident
team: response
stvetro: team
gpt: stvetro
jethabr: gpt
c: jethabr
activ: c
directori: active
printnightmar: directory
jet: printnightmare
csirt: jet
siem: csirt
ptsecur: siem
posit: ptsecurity
technolog: positive
editorgib: technologies
group: editorgib
ib: group
ttp: ib
shaman: ttps
teleport: shaman
kubernet: teleport
firstvd: kubernetes
config: firstvds
sea: config
dirti: sea
pipe: dirty
r: pipe
vision: r
linux: vision
nix: linux
dirtypip: nix
cve: dirtypipe
harden: cve
android: hardening
auditd: android
ebpf: auditd
root: ebpf
read: root
number: read
leramnk: number
voximpl: leramnk
olegspectr: voximplant
devsecop: olegspectr
pre: devsecops
commit: pre
check: commit
spectr: checks
devop: spectr
patientzero: devops
i: patientzero
pwned: i
hibp: pwned
sergkrovel: hibp
astra: sergkrovel
sql: astra
ctf: sql
sqli: ctf
maxrokatanski: sqli
otu: maxrokatansky
alizar: otus
mark: alizar
lukasafonov: marks
valdikss: lukasafonov
globalsign: valdikss
admin: globalsign
esetnod: admin
zhovner: esetnod
jeditob: zhovner
facebook: jeditobe
vk: facebook
telegram: vk
youtub: telegram
habr: youtube
