хабр: хабр хабра
откр: открыть
список: список
стат: стать статьи статья статье статью содержанием
автор: автором авторы автора доверялось вклад
поток: потоки
разработк: разработка разработках разработки разработке управление задание
администрирован: администрирование
дизайн: дизайн
менеджмент: менеджмент
маркетинг: маркетинг
научпоп: научпоп
поиск: поиск
профил: профиль
обнов: обновить
рейтинг: рейтинг рейтинга
промышлен: промышленное отразилось возможно
программирован: программирование автоматного
ас: асу
тп: тп
компан: компании цифровизация крупных сайта
подряд: подряд
скопирова: скопировать
ссылк: ссылку частей содержать
показыва: показывать
нов: новые разработку
лучш: лучшие превратит авторов
порог: порог
уровен: уровень
сложност: сложности
прост: простой
средн: средний
сложн: сложный сложно
примен: применить
час: часа
настройк: настройка
пошагов: пошаговой пошаговая
отладк: отладки отладка
прочтен: прочтение
мин: мин
количеств: количество
просмотр: просмотров
микроконтроллер: микроконтроллеров
производств: производство простоям кейс
электроник: электроники электроника
начина: начинающих
туториа: туториал
записа: записали
прошивк: прошивку прошивка
интерфейс: интерфейс коммуникационным
происход: происходит
мига: мигает
лог: логи
появля: появляются привилегию
отвеча: отвечает
очевидн: очевидно
зависл: зависла
дела: делать процессов дела
поня: понять окончательно
ошибк: ошибка минимизировать
выруч: выручит
подсветк: подсветкой
чита: читать
дал: далее
добав: добавить
закладк: закладки
комментар: комментарии
новост: новости
мар: мар
импортозамещен: импортозамещение
котор: которое
потеря: потеряли
ч: ч
телеграфн: телеграфному
кабел: кабелю
нейрон: нейронные
сет: сети действия
рсубд: рсубд
х: х
блог: блог
еа: еае
консалт: консалт
истор: история решение
искусствен: искусственный искусственного
интеллект: интеллект интеллекта
ретроспектив: ретроспектива
пилотн: пилотная
понрав: понравилась
комьюнит: комьюнити
продолжа: продолжаем
рассказыва: рассказывать
ран: ранних предоставить
советск: советских поговорим
предвосхит: предвосхитивших
современ: современные современных
достижен: достижения
отрасл: отрасли
пор: порой
оперед: опередивших
сво: сво
рассказ: рассказ
полн: полным
упоминан: упоминания
проект: проектов проектах разработкой аналог возьмем нативные
ан: ан
усср: усср
част: часть программу вторая
реализова: реализована расскажу простоями
процесс: процессе процессами оптимизация отдельного учебный
использован: использования
эвм: эвм
ки: киев
кат: катом пожаловать
реч: речь
пойдет: пойдет
управлен: управления онтико физики
технологическ: технологическими
расстоян: расстоянии
км: км
применен: применении
прообраз: прообраза советские
реляцион: реляционных
сист: систем сделать
баз: базами реализованная
дан: данных соответствии информации
перв: первых кратко сделай ссылка прошлое
опыт: опытах
машин: машинному
обучен: обучению продукте развитие
создан: созданию
голос: голосов
фев: фев
параллелизм: параллелизм параллелизма
введен: введение
автоматн: автоматное визуальное представляют составляет
параллельн: параллельное
повод: поводом поводу
написан: написания
послуж: послужило
приятн: приятное
событ: событие сообщений
модератор: модератор
убра: убрал
тег: теги
мо: моей мотивам
крайн: крайней
предшествова: предшествовало
сообщен: сообщение отправку
пользовател: пользователя пользователь
слов: словам последнего
замет: заметил
поспеш: поспешил
извест: известить
свет: свет
дел: деле прав инструменты понимание
скор: скорее
просмотрел: просмотрел
диагона: диагонали
попрост: попросту
вруб: врубился
друг: другим имею соответствовать друг
объясн: объяснить объяснил
се: сей
казус: казус
причин: причины геополитических
заблужден: заблуждения
принят: принято
вниман: внимание
ответ: ответ
тишин: тишина
пошл: пошли
контекст: контексте
рассматрива: рассматриваемой
складыва: складывается
пазл: пазл
произошл: произошло
одн: одно
реш: решивший автору
видим: видимо
поддержа: поддержать
выраз: выразил
благодарн: благодарность
допуст: допустил
лестн: лестные
высказыван: высказывания
адрес: адрес
специалист: специалистов
бауманк: бауманки обобщать
соглас: ним
поскольк: согласен
асфальт: поскольку
роз: асфальте
растут: розы
прав: растут взять нарушало разработчика
содержан: дело связанные
пост: содержании спорными ролью
управля: постов
спорн: управлять
доверя: постами
взят: решил командное
месячник: право
усилен: месячник
модерац: усиленной
стол: модерации
сильн: столь
недовер: сильного
явн: недоверия
вника: явно
проблем: вникал
появлен: проблемы
подобн: появления встроен
логичн: подобных
предостав: логично
реша: ранее сеть
вопрос: решать
связа: вопросы
последн: статей очереди тренд протяжении
содержа: последнее выражено
критик: содержало
цел: критику поставленных обучения текущая
наруша: целом
сообществ: правила обсудить
обобща: сообщества
сто: бауманку
архитектур: стоило
наследован: архитектура реализовать
рол: наследования авторизации обладаю дает
плоск: ролей модель
модел: плоской игру приведением
ооп: модели
перевод: ооп
заход: перевод
авторизац: заходит
вступа: роли
игр: вступают
облада: плоская например
определен: обладает данным россии
набор: определенным разные
привелег: набором
запрос: привелегий
достаточн: запросе
провер: достаточно
нужн: проверить
доступ: нужное компаниях
присутств: доступа
коллекц: присутствует
разн: коллекции наборы
сущност: разных
например: сущностей
социальн: посте
им: социальной
определ: другом
админ: определены
выда: админ
дает: выдает
автоматическ: роль
приобрета: автоматически
привилег: приобретаю
увяза: появляется
дета: увязать
код: детали соответствующим
преврат: коде делаются
продукт: превратить данном
больш: продукт сторону
куч: большую
гряз: кучу
рамк: грязи
расскаж: рамках бизнесом
протестирова: наследование
получен: протестировать
иерарх: полученную
решен: иерархию вариант
попробова: истории захотелось
сдела: попробовал дом
отчет: систему
просто: отчетов контроля
кейс: производства конкретном
работа: производстве панельку
самодельн: работает
систем: самодельная инфраструктура
контрол: система
стар: базе исправление вернуться
приспособл: старая
браузер: приспособлена
захотел: браузеров
рад: попробовать
эксперимент: ради
похож: эксперимента
ускоря: похожее
раст: ускоряем
счаст: растим
команд: счастье рутиной
яндекс: команде службы
конференц: яндекс
олег: конференции
бунин: олега
онтик: бунина
смотрет: проектами
поменя: смотреть
раз: поменять
ускор: раза
командн: ускорить
задач: взятия яндекса поставленную
работ: задачи случай
попадан: работу
артефакт: попадания
продакш: артефакты
муч: продакшена
бесполезн: мучить
рутин: бесполезной
счастлив: команду
автоматизирова: счастливее
подсч: автоматизировать
науч: подсч вариантов туториале
правильн: научиться
график: правильно
посмотр: графики
зовут: посмотрим
никит: зовут
дубк: никита
беларус: дубко
мастер: беларус
подземел: мастер
ещ: подземелий
доброжелюбн: ещ
бородач: доброжелюбный
подкаст: бородач
веб: подкаста
стандарт: веб
руководител: стандарты
служб: руководитель
оптимизац: задача
пойд: делаю пути
текст: пойд
написа: текст идея
мотив: написан
доклад: моего
оцифровк: доклада
жизнен: оцифровка первая
цикл: жизненного жизненный завершению
детал: цикла
помога: деталей
сокраща: помогает
издержк: сокращать
анализ: издержки
проектирован: анализ
инфраструктур: проектирование
песочниц: системы хабы
говор: песочницы
цифровизац: говорят
повыша: компаниям
эффективн: повышать
бизнес: эффективность трансформация
конкретн: расскажем
этап: кейсе
позволя: этапа
пример: позволяет рассмотрим
железнодорожн: примере
индустр: железнодорожной
вагоноремонтн: индустрии
предприят: вагоноремонтному автоматизации
сэконом: предприятию
млн: сэкономить
рубл: млн
сниз: рублей
срок: снизить
инвентаризац: срок
недел: инвентаризации
дня: недель
минимизирова: дня
проведен: ошибки
ремонт: проведении
вкпа: ремонта
визуальн: вкпа
вспомн: программирования
представля: вспомним графы
удобн: представляется
наглядн: удобным
созда: наглядным внутреннем
аналог: создать
основа: проекта
элемент: основан
библиотек: элементов
конечн: библиотеки виде собственно
автомат: конечные конечных процесса
осваива: автоматы
сред: осваиваем
заодн: сред
провед: заодно
сравнен: проведем
технолог: сравнение
основ: технологий
поставлен: основу решающая
возьм: целей
нагревател: проект
выбра: нагреватель
хорош: выбранный
описа: хорош
детальн: описан
позиционируем: детально
пут: позиционируемой
вариант: пойдем клона
вид: решения
привед: автоматов блоках
рис: приведен
форм: рис графическая
графическ: форме
обычн: форма
классическ: обычных
входн: классических исходя
выходн: входным
кана: выходным
привяза: канала
соответств: привязаны случае схемой
предикат: соответствующие названные
действ: предикаты предикатами
граф: задачу
программ: автоматной разделяем примеры школьной
уровн: программы правда
видн: уровне
основн: видны
отлич: основные
кратк: отличия
приближен: первом
свод: приближении
след: сводятся
отдельн: следующему
сраз: автомата
разделя: сразу
оператор: части панели
назва: операторы
собствен: действиями
ка: конечного
общ: ка
случа: общем редчайший
вмест: определением
составля: вместе
упаковк: автоматную частной
круг: упаковка определенных
различн: кругов
диаметр: различных
лист: диаметров
прямоугольник: листов упаковке
зада: прямоугольников
габарит: заданных
инженерн: габаритов
обзор: инженерные
представл: обзор языке
частн: представлен
открыт: прямоугольники
сторон: открытой ошибаются
реверс: стороной
инжиниринг: реверс
китайск: инжиниринг
плк: китайского
софт: плк
умн: софт
дом: умный
познаком: первой
аппаратн: познакомились
обеспечен: аппаратным
клон: обеспечением
подключа: научимся
доступн: подключаться
коммуникацион: доступным
останавлива: интерфейсам
запуска: останавливать представлена
залива: запускать
конц: заливать
рассмотр: конце
задейств: программ
перифер: задействующих
янв: периферию
контейнер: янв
попытк: контейнеров
реализац: попытка яп напомним
приоритетн: реализации
очеред: приоритетной
год: последние
стал: годы
популярн: стала
росс: популярна
интернет: кругах
информац: интернете песочница
дают: обучениях
поверхностн: даются
знан: поверхностные нужда
мног: знания
момент: многие
затрагива: моменты
появ: затрагиваются
иде: появилась
сер: написать
интересн: серию событию
взгляд: интересными
тем: взгляд
встро: темами
скриптов: подобный
язык: скриптовый используя внутреннего кодом
возможн: язык мессенджеры
поговор: возможностях
цифров: прообразы терять
трансформац: цифровой цифровая
ит: трансформации
локальн: ит
российск: локальный
тренд: российский
протяжен: последних
многократн: слово
звуча: многократно
кажд: звучало
утюг: каждого
крупн: утюга промышленности
западн: крупные
вендор: западные
сил: вендоры
геополитическ: силу
ушл: причин
болезнен: ушли
отраз: болезненно
покупк: доступ
лиценз: покупке
поддержк: лицензий техническая
обновлен: поддержке
больн: обновлениям
теря: больно
замедл: бизнеса
распростран: замедлится
мнен: распространено
оп: мнение
автоматизац: опыт
нача: предприятий
девян: начались
галактик: девяностые
монол: галактика
выросл: монолит
ровн: выросли
мест: ровном
подготовк: месте осмыслить
инженер: подготовка
асутп: инженеров
вуз: асутп
будущ: вузе должна
учебн: будущее
трет: процесс
описыва: третья
развит: описывающих
трех: целью
явля: трех
осмысл: является
обсуд: подготовку
должн: сообществом
как: будущем
образ: каким
актуализирова: образом
настоя: актуализировать
втор: настоящее считал
прошл: первую
тестирован: цикл
мобильн: тестирование
приложен: мобильных
разработчик: приложений входных
получа: правило
менеджер: получает
техническ: менеджера дзен
задан: техническое
исправлен: новой
функциональн: старой
выраж: функциональности
требован: ссылки
проч: требований
полезн: прочие
необходим: полезности
задумк: необходимые
исход: задумки
имплементирова: разработчики
отда: имплементировать
завершен: отдать
готов: циклов
релиз: готова
теор: релизу
шагов: теория управлении
двигател: шаговым шаговыми
вертет: двигателем
камер: вертеть
математик: камеру знании
робототехник: математика
наста: робототехники
редчайш: настал
программист: работе замечаю
нужд: программиста
физик: математики
важн: двигателями обе
кинематическ: важно
правд: кинематическую
отнест: уровню
школьн: отнести
класс: программе
культур: класса соседней
об: культуры
ненормальн: важны
замеча: ненормальное
программистск: программисты
инструмент: программистские
изначальн: делятся
долг: изначально
счита: долгое
несер: вторую
зно: несерь
пар: зной
тройк: пару
окончательн: тройку
ошиба: понял старички
старичк: ошибался
числ: большее
люд: число
обратн: людей
знакомств: обратную
соседн: знакомство
пониман: культурой
цен: лучшего
продолж: цена
текущ: продолжим
аттрактор: цель реализацию
достич: аттракторов
равенств: достичь способствовать
результат: равенства
приведен: результатов
универсальн: моделей
использу: универсальной
яп: языки
оста: реализация
так: осталось
соответствова: таком
идеал: другу
одинаков: идеале
совпаст: одинаковые
способствова: совпасть
освоен: равенству
внутрен: освоения блоки
особ: языка
препятств: особых
предвид: препятствий
блок: предвидится создаются блока библиотечных
динамическ: блок
напомн: динамические
лоренц: аттрактора
стандартн: лоренца
библиотечн: стандартных
называ: приведена
исходн: называть
схем: исходной
панел: запускаем
мессенджер: оператора
бот: промышленной напишем
реализуем: бота
туториал: реализуемо
наш: научим
панельк: нашу
напиш: работать
реализу: бот
отправк: реализуем
добр: интересно
пожалова: добро
сюд: кат
вклад: сюда
аккаунт: лучших
войт: аккаунт
регистрац: войти
раздел: регистрация
публикац: разделы
хаб: публикации
устройств: информация
сайт: устройство
документ: компаний
соглашен: документы
конфиденциальн: соглашение
услуг: конфиденциальность
корпоративн: услуги
медийн: корпоративный
реклам: медийная
нативн: реклама
образовательн: проекты
стартап: образовательные
мегапроект: стартапам
дзен: мегапроекты
вернут: поддержка
верс: старую
rss: rss
aabzel: aabzel
jlink: jlink
eclips: eclipse
swd: swd
jtag: jtag
heartbeat: heartbeat
led: led
uart: uart
cli: cli
gdb: gdb
smirnov: smirnov
dm: dm
lw: lws
c: c
simintech: simintech
kirekov: kirekov
spring: spring
secur: security
java: java
editor: editor
viewer: viewer
admin: admin
weron: weron
ms: ms
sql: sql
server: server
report: reporting
servic: services
ii: iis
sqlite: sqlite
javascript: javascript
darkmefodi: darkmefody
cycl: cycle
time: time
d: d
hr: hr
tech: tech
teamlead: teamlead
conf: conf
umnodigit: umnodigital
erp: erp
tau: tau
n: n
x: x
python: python
chupakabra: chupakabra
fx: fx
u: u
dii: diy
mcu: mcu
stm: stm
duino: duino
vakhnovetski: vakhnovetsky
wincc: wincc
oa: oa
scada: scada
simat: simatic
open: open
architectur: architecture
etm: etm
siemen: siemens
control: control
dss: dss
ect: ect
titaev: a
titanium: titaev
io: titanium
prd: ios
http: prd
en: https
wikipedia: en
org: wikipedia
wiki: org
product: wiki
requir: product
document: requirements
figma: document
qa: figma
ptz: qa
yafind: ptz
matlab: yafinder
pl: matlab
langblock: pl
fedorov: langblock
av: fedorov
telegram: av
bot: telegram
hmi: bot
weintek: hmi
api: weintek
echo: api
leono: echo
belerafonl: leono
petuhoff: belerafonl
freecod: petuhoff
xx: freecoder
uuuulala: xx
dtn: uuuulala
advantech: dtn
zalina: advantech
ashagraev: zalina
facebook: ashagraev
twitter: facebook
vk: twitter
youtub: vk
habr: youtube
