новост: новости
выкуп: выкуп
складск: складских
остатк: остатков
сотрудничеств: сотрудничество
вопрос: вопросы
ответ: ответы
корзин: корзина корзину
р: р
регистрац: регистрация регистрацию
вход: вход
многоканальн: многоканальный
отправ: отправить
заявк: заявку
контакт: контакты
мен: меню
компан: компании
оплат: оплата оплате
доставк: доставка доставке
госзакупк: госзакупки
ваканс: вакансии
отзыв: отзывы
обратн: обратная
связ: связь связи
каталог: каталог
лабораторн: лабораторное лабораторная лабораторные лабораторный лабораторных
оборудован: оборудование оборудования
посуд: посуда
строительн: строительное
мебел: мебель
химическ: химические
реактив: реактивы
проч: прочие
принадлежн: принадлежности
показа: показать
вс: вс
актак: актаком
ант: ант
лазер: лазер
атомтех: атомтех
аквилон: аквилон
аппаратурщик: аппаратурщик
б: б
биолаб: биолаб
бмц: бмц
белар: беларусь
биолент: биолент
биомер: биомер
нпп: нпп
биоска: биоскан
биофизическ: биофизическая
аппаратур: аппаратура
бризорб: бризорб
весмастер: весмастер
вессервис: вессервис
взор: взор
вибротехник: вибротехник
владыкин: владыкин
ип: ип
госметр: госметр
гусевск: гусевский
стекольн: стекольный
завод: завод
д: д
диакон: диакон
днк: днк
технолог: технология технологии
дак: дак
спектромед: спектромед
нпф: нпф
даста: дастан
доз: доза
еламед: еламед
з: з
горноспасательн: горноспасательного
згсо: згсо
загорск: загорский
оптик: оптико
механическ: механический
зернотехник: зернотехника
златоустовск: златоустовский
часов: часовой
измерительн: измерительная
техник: техника
импульс: импульс
инфраспак: инфраспак
анал: аналит
констант: константа
корс: корса
кронт: кронт
казанск: казанский
комз: комз
калиброн: калиброн
касимовск: касимовский
приборн: приборный
кимрск: кимрская
фабрик: фабрика
горьк: горького
кита: китай
крисмас: крисмас
плюс: плюс
л: л
лам: ламо
лом: ломо
лабораторик: лабораторика
ламинарн: ламинарные
систем: системы
лив: ливам
пф: пф
литопласт: литопласт
мед: мед
люмэкс: люмэкс
маркетинг: маркетинг
миус: миус
мцбк: мцбк
масс: масса
мегавес: мегавес
медиа: медиана
фильтр: фильтр
медик: медика
медоборудован: медоборудование
па: пао
медтест: медтест
спб: спб
мелиор: мелиор
мет: мета
хром: хром
мидл: мидл
микромед: микромед
минимед: минимед
минимедпр: минимедпром
оо: ооо
н: н
нтм: нтм
защит: защита
нефтехимавтоматик: нефтехимавтоматика
боз: боз
фгуп: фгуп
нпо: нпо
бскб: бскб
нефт: нефть
стандарт: стандарт
нижнетагильск: нижнетагильский
миз: миз
окб: окб
вест: веста
олис: олис
п: п
прибор: прибор приборы
ганк: ганк
панге: пангея
экспосервис: экспосервис
перинт: перинт
петролазер: петролазер
полимастер: полимастер
практик: практик
нц: нц
промприбор: промприбор
промхимприбор: промхимприбор
океан: океанов
рэлтек: рэлтек
росприбор: росприбор
рнпо: рнпо
росс: россия россии
сибагроприбор: сибагроприбор
впк: впк
снол: снол
терм: терм
сц: сц
ормет: ормет
сапфир: сапфир
сартогосм: сартогосм
сафоновск: сафоновский
гидрометприбор: гидрометприбор
семик: семико
сибэкоприбор: сибэкоприбор
пэп: пэп
смоленск: смоленское
сктб: сктб
спу: спу
стройприбор: стройприбор
скб: скб
твес: твес
технотерм: технотерм
тка: тка
нтп: нтп
тайфун: тайфун
термикс: термикс
термоприбор: термоприбор
термэкс: термэкс
техн: техно
ас: ас
техномедик: техномедика
томьанал: томьаналит
тюменск: тюменский
медицинск: медицинского
инструмент: инструментов
тзмо: тзмои
узхп: узхп
ф: ф
фармэк: фармэк
футурум: футурум
фирм: фирма
альф: альфа
бассенс: бассенс
полик: поликом
синтакон: синтакон
форк: форком
х: х
хем: хема
химлаборприбор: химлаборприбор
химэлектроник: химэлектроника
хроматэк: хроматэк
ц: ц
цвет: цвет
цветхр: цветхром
циклон: циклон
тест: тест
э: э
эконикс: эконикс
эксис: эксис
эвис: эвис
экоинструмент: экоинструмент
эков: эковью
эколог: эколог
юг: юг
эксперт: эксперт
экрос: экрос
экох: экохим
электромедоборудован: электромедоборудование
электроприбор: электроприбор
элиз: элиза
ю: ю
юник: юнико
сис: сис
товар: товаров товар товара
актуальн: актуально
контрол: контроля
качеств: качества качество
строительств: строительства
химреактив: химреактивы
главн: главная
зерноперерабатыва: зерноперерабатывающих
производств: производств
отбор: отбора
проб: проб
определен: определения
примес: примесей
электрон: электронный электронной
таймер: таймер
тл: тл
узна: узнать
цен: цену цены
хот: хотите
физическ: физическое
лиц: лицо
юридическ: юридическое
назван: название
организац: организации
телефон: телефон телефону телефонам телефоны
сообщен: сообщение
файл: файл файла
реквизит: реквизитами
допустим: допустимые
расширен: расширения
максимальн: максимальный
размер: размер
ссылк: ссылка
нажим: нажимая
кнопк: кнопку кнопки
соглаша: соглашаетесь
услов: условиями условиях условия
использован: использования использование
политик: политикой политика
конфиденциальн: конфиденциальности
швец: швеция
код: код
артикул: артикула
номер: номер
нестабильн: нестабильным
курс: курсом
валют: валют
уточня: уточняйте уточняющей
срок: сроки
поставк: поставки
продукц: продукцию продукции
почт: почте почту
запрос: запросу запросом
куп: купить
окончательн: окончательную
отдел: отделе
продаж: продаж продаже
подробн: подробнее
добав: добавить
избра: избранное
сравнен: сравнению сравнения сравнение
удал: удалить
обзор: обзор
характеристик: характеристики
поставля: поставляется
предназнач: предназначен
выполнен: выполнения
анализ: анализов
процесс: процессе
зерн: зерна
мук: муки
зернопродукт: зернопродуктов
основн: основные
особен: особенности
оригинальн: оригинальный
дизайн: дизайн
вид: виде
яблок: яблока
лепестк: лепестком
больш: большой
жк: жк
диспл: дисплей
удобн: удобные
запуск: запуска
остановк: остановки
памя: память
последн: последние
установк: установки
магн: магнит
креплен: крепления
металлическ: металлической
поверхн: поверхности
питан: питание
батар: батареи
тип: типа
производител: производитель
может: можете
зада: задать
позвон: позвонив
оставля: оставляет
прав: право права прав
внос: вносить
изменен: изменения
конструкц: конструкцию
комплектац: комплектацию
издел: изделий
предварительн: предварительного
уведомлен: уведомления
представлен: представленная
сайт: сайте сайта сайты
информац: информация информации
каса: касающаяся
нос: носит
информацион: информационный
характер: характер
как: каких
явля: является являются
публичн: публичной
оферт: офертой
определя: определяемой
положен: положениями
стат: статьи
гражданск: гражданского
кодекс: кодекса
российск: российской
федерац: федерации
получен: получения
обраща: обращайтесь
указа: указанным
раздел: разделе
эл: эл
добавлен: добавление
стабильн: стабильной
работ: работы
млн: млн
отгружен: отгруженных
клиент: клиентов
все: всей
причин: причин
покупа: покупать
официальн: официальная
гарант: гарантия
бережн: бережная
честн: честные
высок: высокое
широк: широкий
ассортимент: ассортимент
соответств: соответствие
московск: московская
обл: обл
клин: клин
волоколамск: волоколамское
шосс: шоссе
социальн: социальных
сет: сетях
яндекс: яндекс
дзен: дзен
тик: тик
ток: ток
оптимум: оптимум
материал: материалы
объект: объектами объектов
авторск: авторского
смежн: смежных
запреща: запрещается
копирован: копирование
распространен: распространение
числ: числе
люб: любое
ин: иное
соглас: согласия
правообладател: правообладателя
просмотрен: просмотренные
зарегистрирова: зарегистрироваться
войт: войти
аккаунт: аккаунта
пройд: пройдите
заб: забыли
парол: пароль
вспомн: вспомнил
mail: mail
optimum: optimum
lab: lab
ru: ru
acom: a
adam: acom
agil: adam
technolog: agilent awareness
allsheng: technologies
anton: allsheng
paar: anton
aptaca: paar
archdal: aptaca
arm: archdale
astero: armed
bio: astero
atago: bio
awar: atago
axygen: technology
b: axygen
bacter: b
bandelin: bacter
beckman: bandelin
coulter: beckman
behnk: coulter
elektronik: behnk
behr: elektronik
bel: behr
engin: bel
bellingham: engineering
stanlei: bellingham
binder: stanley
rad: binder
biobas: rad
biologix: biobase
biosan: biologix
bmt: biosan
bochem: bmt
bresser: bochem
brookfield: bresser
burkl: brookfield
c: burkle
ca: c
casella: cas
centropen: casella
circutor: centropen
citizen: circutor
aczet: citizen
corn: aczet
d: corning
daihan: d
deltalab: daihan
demcom: deltalab
diasi: demcom
dirui: diasys
dlab: dirui
dr: dlab
muller: dr
e: muller
elma: e
elmi: elma
eppendorf: elmi
epson: eppendorf
erba: epson
lachema: erba
f: lachema
farmcomp: f
fl: farmcomp
medic: fl
foss: medical
foyom: foss
g: foyomed
gfl: g
gilson: gfl
greetm: gilson
greiner: greetmed
h: greiner
hach: h
lang: hach
haier: lange
hanna: haier
instrument: hanna
haver: instruments
boecker: haver
haw: boecker
heidolph: haws
heinz: heidolph
herenz: heinz
hellma: herenz
hettich: hellma
zentrifugen: hettich
hirschmann: zentrifugen
huber: hirschmann
i: huber
ika: i
improv: ika
infor: improve
intersci: infors
j: interscience
jet: j
filtrat: jet
biofil: filtration
joan: biofil
julabo: joan
jun: julabo
air: jun
system: air
kartel: systems
kern: kartell
sohn: kern
gmbh: sohn
kett: gmbh
kimberli: kett
clark: kimberly
knf: clark
kruss: knf
kyoto: kruss
electron: kyoto
l: electronics
labconco: l
labtex: labconco
lamaplast: labtex
lauda: lamaplast
levenhuk: lauda
liebherr: levenhuk
lind: liebherr
vac: lind
liston: vac
loip: liston
m: loip
martin: m
christ: martin
maxlab: christ
memmert: maxlab
mettler: memmert
toledo: mettler
miel: toledo
millipor: miele
mindrai: millipore
mse: mindray
n: mse
nalgen: n
nikon: nalgene
niksi: nikon
novam: niksy
nuair: novamed
o: nuaire
ohau: o
olympu: ohaus
omron: olympus
operon: omron
osram: operon
p: osram
phcbi: p
sanyo: phcbi
philip: sanyo
polylab: philips
pozi: polylab
primelab: pozis
pyrex: primelab
q: pyrex
qiagen: q
r: qiagen
radwag: r
retsch: radwag
s: retsch
sarstedt: s
sartoriu: sarstedt
sfm: sartorius
hospit: sfm
product: hospital
shatox: products
shimadzu: shatox
shp: shimadzu
steriltechnik: shp
sifin: steriltechnik
diagnost: sifin
sky: diagnostics
watcher: sky
ssi: watcher
stegler: ssi
swelab: stegler
t: swelab
tagler: t
techno: tagler
plastic: techno
tpp: plastic
testo: tpp
thermo: testo
scientif: thermo
tuttnauer: scientific
u: tuttnauer
ulab: u
ultra: ulab
urit: ultra
vedalab: urit
vibra: vedalab
shinko: vibra
vilber: shinko
lourmat: vilber
vitlab: lourmat
w: vitlab
wtw: w
x: wtw
xerox: x
y: xerox
yamato: y
z: yamato
zeiss: z
zoonlab: zeiss
covid: zoonlab
email: covid
select: email
file: select
jpg: files
jpe: jpg
png: jpe
bmp: png
doc: bmp
docx: doc
txt: docx
rtf: txt
pdf: rtf
xl: pdf
xlsx: xls
mb: xlsx
id: mb
zt: id
lr: zt
close: lr
iso: close
info: iso
telegram: info
www: telegram
