хабр: хабр
откр: открыть
список: список
стат: стать статьи статье статей
автор: автором авторы автор авторов
поток: потоки
разработк: разработка разработке разработки
администрирован: администрирование
дизайн: дизайн
менеджмент: менеджмент
маркетинг: маркетинг
научпоп: научпоп
поиск: поиск поиска
профил: профиль
обнов: обновить
рейтинг: рейтинг рейтинга
низкоуровнев: низкоуровневый
байт: байт
код: код кода кодом
исполнен: исполнения
браузер: браузере браузер браузеры браузера
компан: компании компаний
подряд: подряд
скопирова: скопировать
ссылк: ссылку
показыва: показывать
нов: новые новое
лучш: лучшие лучших
порог: порог
уровен: уровень
сложност: сложности
прост: простой простого
средн: средний
сложн: сложный
примен: применить
час: час
проблематик: проблематика
текущ: текущей текущее
концепц: концепции
миров: мировой
сетев: сетевой
инфраструктур: инфраструктуры
решен: решение решении решением
помощ: помощи помощью
децентрализова: децентрализованного
детерминизм: детерминизма
прочтен: прочтение
мин: мин
количеств: количество
просмотр: просмотров
читальн: читальный
зал: зал
истор: история истории
криптовалют: криптовалюты
репортаж: репортаж
привет: привет
уважа: уважаемые
хабровц: хабровцы
пиш: пишу пишем
наболевш: наболевшем
понима: понимаю
информац: информация информации информацию
разрознен: разрозненной
постара: постарался
рассказа: рассказать
основн: основную основным
понят: понятиям
част: часть части
понятн: понятна
мастодонт: мастодонтам
област: области
ознакомительн: ознакомительна
дума: думаю
интересн: интересна
мног: многим многих многие
над: надеюсь
весьм: весьма
откладыва: откладывать
вопрос: вопрос
долг: долгий
ящик: ящик
приступ: приступим
приступа: приступать
голос: голосов
добав: добавить добавили
закладк: закладки
комментар: комментарии
новост: новости
апр: апр
программирован: программирование программирования
компилятор: компиляторы компилятора
перевод: перевод
апрел: апреля
вышл: вышло
очередн: очередное
обновлен: обновление
некотор: некоторые
изменен: изменения изменением
чита: читать
дал: далее
мар: мар
нейросет: нейросеть
тащ: тащили
машин: машинное машинного
обучен: обучение обучения
песочниц: песочницы песочница
сезон: сезон
здравств: здравствуйте
товарищ: товарищи
хоч: хочу
написа: написать написанного
портирова: портировал
задач: задача задачи
пришл: пришла пришлось
ко: ко
мо: моих мое мо
институтск: институтских
друз: друзей друзьями
ивм: ивм
ран: ран
нек: некий
фронтенд: фронтенд фронтенде
доктор: доктор доктору
загружа: загружает
кт: кт
снимок: снимок
предлага: предлагается
веб: веб вебе
интерфейс: интерфейса
выдел: выделить
сектор: сектор сектора
сердц: сердцем
переда: передан
сервер: сервер сервере сервера
алгоритмическ: алгоритмически
отсегментир: отсегментируется
граф: граф
аорт: аорты
послед: последующего
анализ: анализа
попрос: попросили
сдела: сделать сделано
выделен: выделения
затрачива: затрачиваемое
превыша: превышать
секунд: секунд
гоня: гонять
координат: координатами
накладн: накладно
состо: состоит
кадр: кадров
размер: размера
пиксел: пикселей
поэт: поэтому
предложен: предложение
браузерн: браузерном
вариант: варианте варианта
кстат: кстати
калькулятор: калькулятор
использу: используя используем
фреймворк: фреймворк фреймворка
привед: приведен приведены
пример: пример
написан: написания
приложен: приложения приложение приложений приложениях
готов: готового
использован: использования использованием
компьютер: компьютере
ос: ос
использ: используется использующего использующем
язык: язык языках языков языка языке
результат: результате
получ: получим
исполня: исполняемый исполняемых
файл: файл файлов
процесс: процессе
работ: работы
использова: использоваться использовать
отслеживан: отслеживания
корректн: корректности
наш: нашего нашем нашими
сборк: сборки сборке
программ: программы программе
развертыван: развертывания
верс: версию версии версия
страниц: страницы
интернет: интернете
фев: фев
создан: создание создания созданию
модул: модуля модуль модулей модулями
туториа: туториал
небольш: небольшой небольшое
заметк: заметке
рассмотрет: рассмотреть
способ: способов
компиляц: компиляции
разн: разных
подход: подхода подходы подходов
реализу: реализуем
то: той
задачк: задачки
тр: тр
х: х
скомпилиру: скомпилируем
получен: полученный
собствен: собственно
план: план
введен: введении
обсуд: обсудим
постановк: постановку
немножк: немножко
поговор: поговорим
технолог: технологии технология технологий
программн: программной
функциональн: функциональность
как: какие каких какую
возника: возникают
обойт: обойти
подвед: подвед
итог: итог
станет: станет
видн: видно
хорош: хорошая
конц: конце
планир: планируется
бонус: бонуса бонус
скомпилирова: скомпилированных скомпилировать
демонстрац: демонстрация
появ: появилась
поддержк: поддержка поддержкой
блог: блог
обзор: обзор обзора
выпуск: выпуском
пополн: пополнил
поддержива: поддерживающих
взгляд: взгляд
сам: самым самых
значительн: значительным
врем: врем
н: н
разработчик: разработчики
смогут: смогут
работа: работать работает
бэкенд: бэкендом
портирован: портирования
запуска: запускать запускаемый запускаем
угодн: угодно
встроен: встроенных встроенного
устройств: устройствах устройств устройство
бессерверн: бессерверные
функц: функции функциями
вмест: вместо вместе
контейнер: контейнеров
граничн: граничных
вычислен: вычислениях вычисления
преврат: превратить
универсальн: универсальный
подробн: подробности
кат: катом
практик: практика
курс: курсе курса
состоян: состояние состояния
год: годах
ретроспектив: ретроспектива
жерар: жерар
галла: галлан
извест: известен
книг: книги
выпущен: выпущенной
существ: существует существующем существующий
русск: русский
действ: действии
питер: питер
предыдущ: предыдущий предыдущей
опубликова: опубликован
январ: январе
прим: прим
переводчик: переводчика
рассмотр: рассмотрю рассмотрим
начн: начну
событ: событий
посмотрет: посмотреть
сбыл: сбылись
либ: либо
прогноз: прогнозов
сюрприз: сюрпризов
попыта: попытаюсь попытал
предсказа: предсказать
вс: вс
пойд: пойд
дек: дек
реверс: реверсил реверс реверсу
игр: игру игры игрой
инжиниринг: инжиниринг
прошел: прошел
месяц: месяц
момент: момента
счаст: счастья
челлендж: челленджа
платформ: платформе платформы платформой платформах
но: ноя
компилиру: компилируем
запуск: запуска запуску
инструмент: инструмент
назван: названием
утилит: утилита
проверк: проверки
синтаксис: синтаксиса
конфигурацион: конфигурационных
ввод: ввода
документац: документации
собра: собрать собрал
самостоятельн: самостоятельно
скача: скачать
исходник: исходники
установ: установить
необходим: необходимую
сист: систему
д: д
неужел: неужели
вэб: вэбе
заморочек: заморочек
удобн: удобно
пользовател: пользователя
спойлер: спойлер
займ: займ
мся: мся
пут: путь
преимуществен: преимущественно
сценар: сценариев
автоматизац: автоматизации
бэкэнд: бэкэнда
дан: данных
метод: методов
статистик: статистики
мобильн: мобильных
например: например
движок: движок
оста: остается
незаполнен: незаполненной
ниш: ниша
могл: могло могли
позвол: позволить позволит
перенест: перенести
обработк: обработки обработка
непосредствен: непосредственно
клиентск: клиентское клиентскую клиентский клиентской
создава: создавать создавался
полноцен: полноценные
кросскомпиляц: кросскомпиляция
выполня: выполняться
движк: движка
внутр: внутри
библиотек: библиотеки библиотека библиотеку
сайт: сайтов сайта
изначальн: изначально
разработа: разработана
клиент: клиент клиента
серверн: серверных серверную
осуществля: осуществляется
тонк: тонкий
последн: последней последняя
добавл: добавлена
стал: стало
возможн: возможным возможностью возможности
объедин: объединить объединит
един: единый
треб: требуются
минимальн: минимальные
проект: проекте проект проектов проекту проекты
покаж: покажу
передела: переделать
запуст: запустить запустили
проблем: проблема
сурс: сурсов
достаточн: достаточно достаточную
команд: команд команды
докер: докер
образ: образ
линукс: линукс
экспортирова: экспортировать
прочита: прочитать
потрат: потратить
куч: кучу
пониман: понимание
он: оных
трат: тратить
сво: сво своему
кратк: краткие
инструкц: инструкции
окт: окт
открыва: открываем
полн: полным
набор: набором
функциона: функционала функционал
включ: включая
сохранен: сохранение
восстановлен: восстановление
логическ: логическую
репликац: репликацию
уда: удал
нно: нной
баз: базы
вперв: впервые
потряса: потрясающая
вылож: выложена
реш: решили
открыт: открытым
посмотр: посмотрим
разрабатыва: разрабатывается
старт: старту
флагманск: флагманского
ключ: ключ
тайн: тайной
комнат: комнате
сторон: стороны
явля: является
изучен: изученной
поскольк: поскольку
альтернатив: альтернатива
компилирова: компилировался компилировать
предусматрива: предусматривал
взаимодейств: взаимодействия
объект: объектами
действительн: действительности
больш: большого большей
потенциа: потенциала
интеграц: интеграции
уровн: уровне
аспект: аспекты
дела: делал делать
мейлинг: мейлинг
лист: листов листе
ненормальн: ненормальное
захотел: захотелось
поиска: поискать
оказыва: оказывается
никак: никакого
пользова: пользоваться
гугл: гуглом
оператор: оператор
почтов: почтового
цел: целом
рабоч: рабочие
одн: одну
опц: опцию
попутн: попутно
поигра: поиграв
сен: сен
помогл: помогли
альф: альфа
банк: банку
выйт: выйти
трудн: трудного
положен: положения
искусствен: искусственный
интеллект: интеллект
рассказыва: рассказывали
распознаван: распознавании
документ: документов документы
прям: прямо
позволя: позволяет
дава: давайте
разбер: разберем
реальн: реальной
жизн: жизни
авг: авг
хостинг: хостинг
вебсайт: вебсайта
создад: создадим
загруз: загрузим
требован: требования
учетн: учетная
зап: запись
желан: желание
узнава: узнавать
экспериментирова: экспериментировать
нуж: нужен
бесплатн: бесплатная
законч: закончим
июн: июн
удив: удивить
благодар: благодаря
доступн: доступны
развит: развитием
заметн: заметных
имеет: имеет
производительн: производительность производительности
комфортн: комфортной
задума: задумался
прикрут: прикрутить
пет: пет
плагин: плагинов
потенциальн: потенциально
переиспользова: переиспользовать
избав: избавится
распространен: распространении
представля: представляет
десктопн: десктопное
собира: собирается
пошел: пошел
смотрет: смотреть
ма: мая
процессор: процессор процессора
максимум: максимуму
мультипоточн: мультипоточность
высок: высокая
ускорен: ускорении
задействова: задействовать
вычислительн: вычислительные
ресурс: ресурсы
нарисова: нарисовали
фракта: фрактал
ньютон: ньютона
задейству: задействуем
параллельн: параллельные
доб: добиться
ещ: ещ
вжив: вживую
увидет: увидеть
прирост: прирост
скорост: скорости
онлайн: онлайн
дем: демо
составля: составляет
сравнен: сравнению
обычн: обычной
реализац: реализацией
сюд: сюда
вклад: вклад
аккаунт: аккаунт
войт: войти
регистрац: регистрация
раздел: разделы
хаб: хабы
соглашен: соглашение
конфиденциальн: конфиденциальность
услуг: услуги
корпоративн: корпоративный
медийн: медийная
реклам: реклама
нативн: нативные
образовательн: образовательные
стартап: стартапам
спецпроект: спецпроекты
яндекс: яндекс
дзен: дзен
настройк: настройка
техническ: техническая
вернут: вернуться
стар: старую
webassembl: webassembly
rss: rss
valerylinkov: valerylinkov
web: web
xo: xo
kotlin: kotlin
dmitriyvaletov: dmitriyvaletov
javascript: javascript
c: c
machin: machine
learn: learning
good: a
stori: good
d: story
aem: d
efram: aem
egui: eframe
github: egui
rust: github
pwa: rust
window: pwa
action: windows
page: action
tugcga: pages
emscripten: tugcga
assemblyscript: emscripten
python: assemblyscript
wasm: python
pack: wasm
honyaki: pack
rubi: honyaki
skillfactori: ruby
rail: skillfactory
fullstack: rails
nzeemin: fullstack
man: nzeemin
state: manning
threadedstream: state
time: threadedstream
wasmwood: time
root: wasmwood
ri: root
h: ris
android: h
validatekeymap: android
kl: validatekeymaps
kcm: kl
idc: kcm
virtualkei: idc
dmitriizolotov: virtualkeys
assembl: dmitriizolotov
otu: assembly
kivi: otus
opengl: kivy
nodej: opengl
ssvm: nodejs
virtual: ssvm
anoshenko: virtual
rui: anoshenko
prikalel: rui
build: prikalel
godot: build
sourc: godot
linux: source
support: linux
export: support
templat: export
ue: template
debain: ue
bit: debain
postgr: bit
snaplet: postgres
supabas: snaplet
postgresql: supabase
pg: postgresql
dump: pg
crunchi: dump
data: crunchy
hn: data
scienc: hn
flutter: science
dart: flutter
js: dart
dom: js
terra: dom
incognita: terra
api: incognita
html: api
hixon: html
serverless: hixon
openjdk: serverless
java: openjdk
sqlite: java
amber: sqlite
dev: amber
site: dev
smartengin: site
smart: smartengines
engin: smart
zfima: engines
pyscript: zfima
azur: pyscript
static: azure
visual: static
studio: visual
code: studio
py: code
vscode: py
id: vscode
caiiiycuk: ide
do: caiiiycuk
dosbox: dos
duke: dosbox
doom: duke
red: doom
alert: red
warcraft: alert
rpg: warcraft
dll: rpg
osx: dll
gnu: osx
envoi: gnu
alordash: envoy
simd: alordash
ruvd: simd
graal: ruvds
ozkriff: graal
m: ozkriff
rko: m
ru: rko
vd: ru
andreynagih: vds
valshavel: andreynagih
phillennium: valshavel
facebook: phillennium
twitter: facebook
vk: twitter
telegram: vk
youtub: telegram
habr: youtube
