хабр: хабр
откр: открыть
список: список
стат: стать статьи статье статья
автор: автором авторы автору авторов
поток: потоки
разработк: разработка разработки разработкой разработку
администрирован: администрирование
дизайн: дизайн
менеджмент: менеджмент
маркетинг: маркетинг
научпоп: научпоп
поиск: поиск
профил: профиль
обнов: обновить
рейтинг: рейтинг рейтинга
инструмент: инструмент инструментов инструменты
игр: игр игры игре
компан: компании компаний
подряд: подряд
скопирова: скопировать
ссылк: ссылку
показыва: показывать
нов: новые новое новом
лучш: лучшие лучших
порог: порог
уровен: уровень
сложност: сложности
прост: простой
средн: средний
сложн: сложный
примен: применить
минут: минут
выражен: выражение
числ: числа число
вид: виде
букв: букв
прочтен: прочтение
мин: мин
количеств: количество
просмотр: просмотров
программирован: программирование
песочниц: песочницы песочница
разрабатыв: разрабатывая
сталкива: сталкиваются
выраз: выразить
сокращен: сокращенную
форм: форму
использ: используются
маленьк: маленькие
знак: знаков
принцип: принципе принципами
выража: выражать
существ: существующем
пример: примера пример
проект: проекте проект проекты
созд: создам
отображен: отображение
монет: монет
кнопк: кнопку
умножа: умножать
нек: некое
значен: значение
чита: читать читали
дал: далее
добав: добавить
закладк: закладки
комментар: комментарии
новост: новости новостей
мар: мар
вариант: вариант
туториа: туториал
слыш: слышу
вопрос: вопросы вопрос
реализац: реализацию реализация реализации
паттерн: паттерна
поэт: поэтому
постара: постараюсь
показа: показать
рабоч: рабочий
исполнен: исполнения
взят: взятую
спрос: спроса
картинк: картинку
голос: голосов
архитектур: архитектура архитектуру
част: часть
блог: блог
привет: привет
зовут: зовут
игор: игорь
гулькин: гулькин
разработчик: разработчик разработчика разработчиков разработчики
накоп: накопилось
опыт: опыта
хотел: хотел
подел: поделиться
подход: подходами подходы
помощ: помощью
реализова: реализовать
гибк: гибко
фреймворк: фреймворка
цел: цель
доклад: доклада
дат: дать
готов: готовое
решен: решение
ход: ход
мысл: мыслей
выстраива: выстраивается
перв: первую
рекоменд: рекомендую
прочита: прочитать
поеха: поехали
истор: истории
контроллер: контроллера
совершен: совершенный совершенно
код: код
мнен: мнение
прошл: прошло
дня: дня
изобретен: изобретения
концепц: концепции концепция
спор: споры
модификац: модификации
заверша: завершаются
се: сей
очевидн: очевидно
изначальн: изначальном изначально
ужасн: ужасна
объектн: объектно
ориентирова: ориентирована
избыточн: избыточна избыточно
налич: наличие
разделен: разделение
визуализац: визуализации
бизнес: бизнес
логик: логики
явля: является
сердц: сердцем
живет: живет
иде: идея
замылива: замыливается
понятн: понятно
мест: месте
должн: должна
биндинг: биндинга биндинг
игров: игровом игровые игровых игрового
движк: движке
появ: появился
косвен: косвенно
подробн: подробно
рассказыва: рассказываю
след: следующем следует
виде: видео
редактор: редактор редактором
приложен: приложения
треб: требует
знан: знания
доступн: доступных
умен: умения
пользова: пользоваться
дан: данной данная
описа: описаны
основ: основы
работ: работы работа работу работе
начина: начинающих
возможн: возможно возможность
опытн: опытные
найдут: найдут
управлен: управление управлением
консол: консоли
постав: поставил
задач: задачу задачи задачами
сдела: сделать
платфомер: платфомер
стил: стиле
рассматрива: рассматривал
конкретн: конкретно конкретные
модел: модель
игрок: игрок игроком
игра: играет
клавиатур: клавиатуре
геймпад: геймпаде
поиска: поискав
интернет: интернете
грамотн: грамотно
л: л
полезн: полезного
пришл: пришлось
создава: создавать
ид: идею
интересн: интересное интересна интересные
дайджест: дайджест дайджесте дайджеста
григор: григорий
дядиченк: дядиченко
техническ: технический техническая
продюсер: продюсер
выпуск: выпуске выпуск
обновлен: обновление
физик: физике
работа: работает работать
красив: красивое красивую красивые
процедурн: процедурно
генерируем: генерируемое
неб: небо
мног: многое многие многого
заход: заходите
кат: кат
фев: фев
кратн: кратное
ускорен: ускорение
загрузк: загрузки
геометр: геометрии
высок: высокая
производительн: производительность
график: графикой графика графики
кейс: кейс
арт: артем
толстогуз: толстогузов
вхож: вхожу
групп: группу
анонимн: анонимных
программист: программистов
навязчив: навязчивое
желан: желание
перелож: переложить
небольш: небольшой
фетиш: фетиш
област: области
оптимизац: оптимизаций оптимизациям
хроническ: хронический
интерес: интерес интересен
шейдер: шейдерам
графическ: графическому
пайплайн: пайплайну
технолог: технологиям технологии
патологическ: патологический
синдр: синдром
самозванц: самозванца
любл: люблю
тестирова: тестировать
разн: разные
алгоритм: алгоритмы
довод: доводить
совершенств: совершенства
отдельн: отдельные
механизм: механизмы
иска: искать
нетрадицион: нетрадиционные
метод: методы
велосипед: велосипедов
проверя: проверять
имеющ: имеющиеся
усовершенствован: усовершенствования
вышл: вышло
конц: конце
позва: позвали
котор: котором
страст: страсть
сильн: сильно
обостр: обострились
получ: получил
поддержк: поддержку поддержкой поддержка
ракет: ракеты ракет
аним: аниме
наш: нашем
пятничн: пятничном
плюс: плюс
бонусн: бонусная
рубрик: рубрика
интересует: интересуетесь
математик: математика
самонаводя: самонаводящихся
перевод: перевод
созда: создал
прототип: прототип
ракетн: ракетной
атак: атаки
понадоб: понадобилась
хитр: хитрая
рассказа: рассказано
поговор: поговорим поговорить
кубическ: кубических
крив: кривых
без: безье
шум: шуме
перлин: перлина
инструкц: инструкция
внедрен: внедрению
хорош: хорошая
объясня: объясняет
вещ: вещи
билд: билдится
выдава: выдавать
непонятн: непонятно
откуд: откуда
взявш: взявшихся
ошибок: ошибок
трех: трех
дневн: дневной
пляск: пляски
бубн: бубном
уда: удалось
так: таки
настро: настроить
сист: систему
корректн: корректной
дел: делюсь
примерн: примерно
нача: начал
библиотек: библиотекой
настольк: настолько
привык: привык
представля: представляю
обход: обходиться
знаком: знакомые
вер: верят
мо: моим моего
восторжен: восторженным
отзыв: отзывам
попроб: попробую
пальц: пальцах
улучш: улучшить
ежедневн: ежедневными
персонаж: персонажа
и: ии
шерст: шерсть
сегодняшн: сегодняшнем
добр: добро
пожалова: пожаловать
полн: полной
нацел: нацелена
локализац: локализации
друг: другого
позволя: позволяющее
значительн: значительно
сократ: сократить
интерфейс: интерфейса
представл: представлена
сцен: сцена
передвига: передвигается
зелен: зеленый
куб: куб кубом
управля: управляемый
мышк: мышкой
син: синяя
капсул: капсула
перемеща: перемещаются
бел: белому
плейн: плейну
красн: красных
препятств: препятствий
вс: вс
попа: попалось
глаз: глаза
недел: неделю
гайд: гайд
устранен: устранению
зависим: зависимостей
пост: поста посте посты
перенос: переносите
использован: использования
чист: чистые
определен: определенно
столкн: столкн
те: тесь
проблем: проблемой
фантомн: фантомных
скрыт: скрытых
устаревш: устаревших
неиспользуем: неиспользуемых
ссылок: ссылок
ассет: ассеты ассетов
привест: привести
дублирован: дублированию
памят: памяти
найдет: найдете
встрет: встретившиеся
случа: случаи
разреш: разрешил
реш: решил
вест: вести
отбир: отбирая
произошл: произошло
ролик: ролики
тексел: тексел тексель
хочет: хочется
текстур: текстурах
базов: базовых
понят: понятиях
компьютерн: компьютерной
тем: тема
сюд: сюда
вклад: вклад
ваканс: вакансий вакансии
аккаунт: аккаунт
войт: войти
регистрац: регистрация
раздел: разделы
хаб: хабы
информац: информация
устройств: устройство
сайт: сайта
документ: документы
соглашен: соглашение
конфиденциальн: конфиденциальность
услуг: услуги
корпоративн: корпоративный
медийн: медийная
реклам: реклама
нативн: нативные
образовательн: образовательные
программ: программы
стартап: стартапам
спецпроект: спецпроекты
яндекс: яндекс
дзен: дзен
настройк: настройка
язык: языка
вернут: вернуться
стар: старую
верс: версию
uniti: unity
d: d
rss: rss
xoiox: xoiox
c: c
idl: idle
ipashelovo: ipashelovo
mvvm: mvvm
p: p
s: s
maxrokatanski: maxrokatansky
zenject: zenject
otu: otus
tac: tac
mvc: mvc
net: net
recoveri: recovery
mode: mode
model: model
view: view
control: controller
maksimkak: maksimkaks
m: m
sk: sk
hot: hot
seat: seat
dyadichenkoga: dyadichenkoga
job: job
system: system
getrend: getrender
cpu: cpu
gpu: gpu
behavior: behavior
tree: tree
asperit: asperite
patientzero: patientzero
rotat: rotation
minim: minimizing
frame: frames
pixnek: pixnek
ar: ar
face: face
track: tracking
android: android
io: ios
vr: vr
unirx: unirx
urp: urp
bustedbunni: bustedbunny
ui: ui
toolkit: toolkit
local: localization
data: data
bind: binding
bogyfal: bogyfall
unigin: unigine
navmesh: navmesh
mitai: mitay
wall: walle
address: addressables
resourc: resources
assetbundl: assetbundles
cgi: cgi
basmanovdaniil: basmanovdaniil
thisiszolden: thisiszolden
soulburn: soulburner
nightrain: nightrain
plarium: plarium
darina: darina
pl: pl
fischer: fischer
barrettdesign: barrettdesign
frozmatgam: frozmatgames
facebook: facebook
twitter: twitter
vk: vk
telegram: telegram
youtub: youtube
habr: habr
