хабр: хабр хабре
откр: открыть
список: список
стат: стать статью
автор: автором авторов авторы автор
поток: потоки поток потоке
разработк: разработка разработке разработки
администрирован: администрирование
дизайн: дизайн
менеджмент: менеджмент
маркетинг: маркетинг
научпоп: научпоп
поиск: поиск
профил: профиль
обнов: обновить
час: часов
дайджест: дайджест
новост: новостей новостям новости
недел: неделю недели
писа: писали
уровен: уровень
сложност: сложности
средн: средний
прочтен: прочтение
мин: мин
количеств: количество количества
просмотр: просмотров
научн: научно
популярн: популярное популярную
здравств: здравствуйте
вячесла: вячеслав
голован: голованов
курир: курирую
сред: среди среды средам
мо: моих
задач: задач
увеличен: увеличение
публикац: публикаций публикации
числ: числе числа
привлечен: привлечение
нов: новых новая новую
хорош: хороших
хотел: хотели
написа: написать
тем: тему
боя: боялись
нача: начать
знак: знак
может: можете
обсуд: обсудить
личн: личные
сообщен: сообщения
песочниц: песочницу песочница
кинут: кинуть
ссылк: ссылку
пройд: пройдусь
уходя: уходящей
наш: нашей
редакц: редакции
сто: стоило
освет: осветить
подробн: подробнее
получ: получилось получить
многорук: многорукие
астроном: астрономы астрономами
нашл: нашли
горяч: горячий горячим горячих горячие
нептун: нептун нептуном нептунов нептуны
существова: существовать
расстоян: расстоянии
светов: световых
орб: орбите
стар: старой старую
звезд: звезды звезде звезда
враща: вращается вращающихся вращающийся
маловероятн: маловероятная
редк: редкая редких
планет: планета планет планеты
тип: тип типа
называ: называют
явля: является
небольш: небольшого небольшая небольшое небольших
обнаружен: обнаруженных
наход: находятся находится находить
сво: своим свой
зв: зв
здам: здам здами
мощн: мощное
здно: здное здной
излучен: излучение
уничтож: уничтожить уничтожена
атмосфер: атмосферы атмосферу атмосфера
остав: оставив
планетарн: планетарное
ядр: ядро ядра
как: каким
образ: образом образ
сохран: сохранила
проход: проходит
орбит: орбиту
дня: дня
назва: названная
плотн: плотная
несмотр: несмотря
радиус: радиус радиуса
примерн: примерно
вдво: вдвое
юпитер: юпитера
плотност: плотность плотности
составля: составляет
низк: низкой низким
сил: сил
держа: держаться
редчайш: редчайшая
существ: существует существующие
горстк: горстка
размер: размером
главн: главной главный
последовательн: последовательности
единствен: единственный
так: такого таким такими
подобн: подобные
нехарактерн: нехарактерные
небесн: небесные
тел: тела
интересн: интересны
показыва: показывают
предел: пределы
возможн: возможностей возможность возможности
природ: природы
помога: помогают
уч: уч
ным: ным
постро: построить
соверш: соверш
нны: нные
модел: модели моделях
объясн: объяснить
оста: остаться
предполож: предположить
испытыва: испытывала
миграц: миграции
инфляц: инфляции
систем: система системы системах системами системе
достигл: достигла
возраст: возраста
млн: млн
больш: большая большого
част: часть
должн: должна должны
существован: существования
пишут: пишут
специалист: специалист
анатом: анатомии анатомия
рассказа: рассказал
сидет: сидеть
скрещ: скрещ скрещены
нным: нными
ног: ногами ноги нога ногу ног
плох: плохо
обрат: обратите
вниман: внимание
осанк: осанку осанки
дела: делают
сверх: сверху
люд: людей
кладут: кладут
прав: правую
лев: левую
наоборот: наоборот
имеют: имеют
предпочтен: предпочтений
способ: способа
стул: стуле
скрещива: скрещивать
полож: положив
кол: колено
лодыжк: лодыжку
удобн: удобно
исследован: исследования исследований исследовании
говор: говорят
поз: поза
вредн: вредна вредного
здоров: здоровья
сиден: сидение
привест: привести
смещен: смещению
б: б
дер: дер
одн: одно одном
выш: выше
друг: другого другими
изменя: изменяет изменяющей
скорост: скорость
движен: движения
кров: крови
кровеносн: кровеносным кровеносных
сосуд: сосудам сосудов
нижн: нижних
конечн: конечностей
увелич: увеличить
риск: риск риска риском
образован: образования
тромб: тромбов
большинств: большинство
клад: кладя
хуж: хуже
класт: класть
повышен: повышению
кровян: кровяного кровяное
давлен: давления давление
скоплен: скопления скоплениях
вен: венах
сердц: сердцу
приход: приходится
преодолева: преодолевать
препятств: препятствие
поврежден: повреждения
поэт: поэтому
измеря: измеряют
стоя: стоять
ровн: ровно
пол: полу
мног: многие многих
фактор: факторы
связа: связанные
скрещиван: скрещиванием
скор: скорее
усугубля: усугубляются
основн: основными основном
проблем: проблемами
малоподвижн: малоподвижный
жизн: жизни
ожирен: ожирение
совет: совет
положен: положении
регулярн: регулярно
вест: вести
активн: активный
и: ии
помог: помог
доказа: доказать
множеств: множество
зд: зд
втор: второго
поколен: поколения поколение
обогат: обогатились обогатили
элемент: элементами элементов элементы
рожд: рожд
сверхнов: сверхновых
перв: первые первыми первых первая
род: родившиеся родилась
вскор: вскоре
взрыв: взрыва
состоя: состояли
водород: водорода
гел: гелия
след: следующее следует
содержа: содержало
тяж: тяж
лых: лых
произвед: произвед
нных: нных
поня: понять
эволюц: эволюцию
вселен: вселенной
исследовател: исследователям исследователь исследователей исследователи
необходим: необходимо необходима
изуча: изучать
зды: зды
бедн: бедные бедных
металл: металлами
тяжел: тяжелее
счаст: счастью
наблюда: наблюдаются наблюдаемых
галактик: галактике
млечн: млечный
пут: путь
основ: основе
разработа: разработанного разработали
алгоритм: алгоритма
контролируем: контролируемого
машин: машинного
обучен: обучения обученного
теоретическ: теоретических
нуклеосинтез: нуклеосинтеза
обнаруж: обнаружили обнаружить
чрезвычайн: чрезвычайно
химическ: химический
отпечаток: отпечаток
говоря: говорящий
нескольк: несколькими
предыдущ: предыдущих
результат: результат результатами
предполага: предполагает
формирова: формировались
внест: внести
вклад: вклад
обогащен: обогащение
ран: ранней
межзв: межзв
ведущ: ведущий
работ: работы
хартвиг: хартвиг
теор: теория
массивн: массивнее
солнц: солнца
естествен: естественно
ожида: ожидать
газов: газовом
облак: облаке
масс: массой
миллион: миллион
находк: находка
позволя: позволяет
рожда: рождались
одиночк: одиночку
состав: составе
здног: здного
бинарн: бинарной бинарными
множествен: множественной
означа: означает
мож: можем
налич: наличия
гравитацион: гравитационных
волн: волн
порожд: порожд
смогут: смогут
будущ: будущие
мисс: миссии
космос: космосе
лун: луне
профессор: профессор
чиак: чиаки
кобаяс: кобаяси
ны: ные
выяв: выявили
пробл: проблем
котор: которыми которое
долж: должен
разобра: разобраться
внедрен: внедрении внедрения
озл: озлем
гариба: гарибай
доцент: доцент
кафедр: кафедры
промышлен: промышленной
инженер: инженерии инженеры
сист: систем
управлен: управления управление
технолог: технология технологий
стал: стала
занима: занимать
заметн: заметное
мест: место
аспект: аспектах
пород: породив
тщательн: тщательно
изуч: изучить
например: например
грядущ: грядущая
повсеместн: повсеместная
интеграц: интеграция
искусствен: искусственного искусственную
интеллект: интеллекта
существен: существенно
повлия: повлиять
человек: человека
ещ: ещ
конц: конца
понят: понятен
работа: работающая
применен: применением
открыт: открытии
материал: материалов
лекарств: лекарств
влия: влияет
социальн: социальные
групп: группа групп
определ: определили
важн: важных
реш: решить
благополуч: благополучие благополучию
повыша: повышающие
внимател: внимателен
пользовател: пользователя
взаимодейств: взаимодействующего взаимодействие
ответствен: ответственность
преимуществ: преимущества
использова: использоваться
соответствова: соответствовать
человеческ: человеческим
ценност: ценностям
приоритет: приоритетам
снижа: снижать
непредвиден: непредвиденных
последств: последствий
нарушен: нарушений
этическ: этических
норм: норм
конфиденциальн: конфиденциальность
сбор: сбор
использован: использование использования
распространен: распространение
дан: данных
продума: продуманы
обеспечен: обеспечения
защит: защиты
частн: частной
предотвращен: предотвращения
отдельн: отдельных
лиц: лиц
проектирован: проектирование
лежа: лежать
фреймворк: фреймворк
позвол: позволит позволило
разделя: разделять
треб: требующий
специальн: специальных
мер: мер
высок: высоким высокой
реализовыва: реализовывать
вообщ: вообще
надзор: надзор
учитыва: учитывающая учитывались
жизнен: жизненный
цикл: цикл
концепц: концепции
формирован: формирования
этичн: этичных
справедлив: справедливых
отношен: отношений
людьм: людьми
основыва: основывалось
фундаментальн: фундаментальном
принцип: принципе
уважен: уважения
когнитивн: когнитивных
способн: способностей
частност: частности
сохраня: сохранять
полн: полный
контрол: контроль
поведен: поведением
нест: нести
провод: проводилось
течен: течение
месяц: месяцев
мнен: мнения
международн: международных
эксперт: экспертов
имеющ: имеющих
различн: различный
оп: опыт
област: области
устойчив: устойчивую устойчивостью
враждебн: враждебным
кож: кожу кожей кожа
вдохнов: вдохновившись
кальмар: кальмаром кальмара кальмаров
даляньск: даляньского
технологическ: технологического
университет: университета
кита: китае
созда: создали созданная
вдохновл: вдохновл
нну: нную
цвет: цвет
электрон: электронная
описа: описанная
журнал: журнале
облада: обладает обладающие
гибкост: гибкостью
экстремальн: экстремальным
температур: температурам
антибактериальн: антибактериальными антибактериальной
свойств: свойствами
доктор: доктором доктор
ни: ниу
коллег: коллегами
основа: основана
фотон: фотонно фотонной фотонную фотонная
ион: ионной ионы ионную
синхрон: синхронно
выдава: выдавать
оптическ: оптические
электрическ: электрические
сигнал: сигналы
встро: встроены
молекул: молекулы
монолаурин: монолаурина
уничтожа: уничтожать
бактер: бактерий
грибк: грибков
имеет: имеет
ярк: яркий
структурн: структурный
обусловлен: обусловленный
слоист: слоистой
наносборк: наносборкой
отража: отражающих
белк: белков
иридофор: иридофорах
поясн: пояснил
успешн: успешно
наноструктур: наноструктуру наноструктура
помощ: помощью
иерархическ: иерархической
самосборк: самосборки
локализова: локализована
эластичн: эластичной
гелев: гелевой
сет: сети
введ: введены
антифриз: антифриз
проводя: проводящие
тег: теги
хаб: хабы
голос: голосов
добав: добавить
закладк: закладки
комментар: комментарии
карм: карма
рейтинг: рейтинг
проповед: проповедую
храм: храме
наук: науки
задонат: задонатить
сайт: сайт сайта
вконтакт: вконтакте
комментирова: комментировать
лучш: лучшие
сутк: сутки
похож: похожие
истор: истории
аккаунт: аккаунт
войт: войти
регистрац: регистрация
раздел: разделы
компан: компании компаний
информац: информация
устройств: устройство
документ: документы
соглашен: соглашение
услуг: услуги
корпоративн: корпоративный
блог: блог
медийн: медийная
реклам: реклама
нативн: нативные
проект: проекты
образовательн: образовательные
программ: программы
стартап: стартапам
мегапроект: мегапроекты
яндекс: яндекс
дзен: дзен
настройк: настройка
язык: языка
техническ: техническая
поддержк: поддержка
вернут: вернуться
верс: версию
sly: sly
g: g
tic: tic
b: b
ucf: ucf
chemic: chemical
engin: engineering
journal: journal
peg: peg
twitter: twitter
facebook: facebook
vk: vk
telegram: telegram
youtub: youtube
habr: habr
