хабр: хабр хабру
откр: открыть открыл
список: список
стат: стать статьи статье статей статья
автор: автором авторы авторов
поток: потоки
разработк: разработка разработкой разработки разработке
администрирован: администрирование
дизайн: дизайн
менеджмент: менеджмент
маркетинг: маркетинг
научпоп: научпоп
поиск: поиск
профил: профиль
обнов: обновить
рейтинг: рейтинг рейтинга
тестирован: тестирование тестирования тестировании тестированию тестированием
мобильн: мобильных мобильное мобильного мобильными
приложен: приложений приложение приложения приложениями приложениях
метод: методы
совет: советы
оп: опыт
компан: компании компаний
подряд: подряд
скопирова: скопировать
ссылк: ссылку
показыва: показывать
нов: новые новое новыми новых новым новый
лучш: лучшие лучшем лучшим лучших
порог: порог
уровен: уровень
сложност: сложности
прост: простой
средн: средний
сложн: сложный сложной сложные сложными сложно
примен: применить
час: часов
рев: ревью
программистск: программистском
прочтен: прочтение прочтения
мин: мин
количеств: количество количества
просмотр: просмотров
сист: систем систему
управлен: управление управления
песочниц: песочницы песочница
собеседован: собеседовании
тестировщик: тестировщиков тестировщик тестировщики тестировщиком тестировщика тестировщикам
зада: задаю задаются задали
вопрос: вопрос вопросом вопросов
дела: делают
команд: команде команды команда командой
слыш: слышу
ответ: ответ ответить
разн: разные разного
вариац: вариации
разработчик: разработчики разработчикам разработчиком разработчик
вника: вникал
обща: общаемся
никт: никто
знает: знает
питон: питон
тест: тесты тест тестов
написа: написаны написать написано
н: н
неужел: неужели
подход: подходит подход подходы подходом
дава: давайте
начн: начнем начну
ручн: ручного
над: надеюсь
ник: никого
удивл: удивлю
относ: относится
код: коду кода коде
слыша: слышали
аналитик: аналитики аналитика
прототип: прототипов
кейс: кейсов кейс
внедря: внедряли
работа: работают работать
хорош: хорошие
специалист: специалисты специалист специалистам
б: б
аг: ага
вс: вс
полезн: полезными полезным полезный
встреч: встречами
понима: понимаю
искрен: искренне
счита: считаю
обо: обоих
пункт: пунктах
происход: происходит
рационализац: рационализация
страх: страха
страшн: страшно
работ: работу работы работа работе
друг: другим друг друга
обнаруж: обнаружить
пробел: пробелы
знан: знаниях знания
проигра: проиграть
сравнен: сравнении
узна: узнали узнать
помощ: помощь помощью помощи
культур: культура
чита: читать
дал: далее
голос: голосов
добав: добавить
закладк: закладки
комментар: комментарии
новост: новости новостями
мар: мар
привлеч: привлечь
млн: млн
пользовател: пользователей
геймификац: геймификации геймификацию
спортмастер: спортмастера спортмастер
блог: блог
игр: игр игры игру
повышен: повышение повышением повышении повышения
конверс: конверсии
запуст: запустили запустить
встро: встроив
дополнительн: дополнительные дополнительных
сервис: сервисы сервисов сервисам
мед: медиа
трекер: трекер
активн: активности активность активных активно
трансляц: трансляции
онлайн: онлайн
тренировк: тренировки
закрыва: закрывают
потребн: потребности
наш: наших нашего нашей
клиент: клиентов клиенты
связа: связанные
покупк: покупками
например: например
помога: помогают
след: следить
спортивн: спортивными
поддержива: поддерживать
физическ: физическую
част: частью части
сообществ: сообщества сообществ сообществом
единомышленник: единомышленников
некотор: некоторые
заход: заходили
ещ: ещ
воспринима: воспринимали
магазин: магазин
товар: товаров
спорт: спорта
познаком: познакомить
покупател: покупателей
возможн: возможностями возможностью возможностей возможно возможности
увелич: увеличить
числ: число
реш: решено решить решим
зовут: зовут
серг: сергей
вылекжанин: вылекжанин
начальник: начальник
отдел: отдела
пост: посте пост поста
расскаж: расскажу
использ: используют используются используется
бизнес: бизнес бизнеса
цел: целях цель целых
привлечен: привлечения
удержан: удержания
стимулирован: стимулирования
покупок: покупок
продвижен: продвижения
услуг: услуг услуги
исключен: исключение
запуск: запуске
придержива: придерживались
принцип: принципов
клиентоориентирован: клиентоориентированность
провел: провели
исследован: исследование
учл: учли
интерес: интересы интересующий
концепц: концепции
сдела: сделать
вовлека: вовлекающей
коммерческ: коммерческая
эффективн: эффективность эффективности эффективного
отказа: отказались отказаться
аренд: аренды
готов: готовых готовы готова
решен: решений решению решение решения
разработа: разработали
собствен: собственную собственных
информацион: информационную
поможет: поможет
многократн: многократно
перезапуска: перезапускать
вложен: вложений
конечн: конечном
итог: итоге
полност: полностью
оправда: оправдал
внедрен: внедрение внедрению
автоматизац: автоматизации автоматизацией
проект: проект проекта проекте проекты
веб: веб
перевод: перевод
автоматизирова: автоматизированных автоматизированного
тестир: тестируют
явля: является являюсь
задач: задачей задача задачу задач
выбор: выбора
уровн: уровней уровне уровня
проверк: проверки
тестов: тестовыми тестовом тестовые
дан: данными данной данным данный
подбор: подбора
подходя: подходящей
библиотек: библиотеки
основыв: основываясь
сво: своем свой
опыт: опыте опыта
подготов: подготовил
руководств: руководство
прогна: прогнать
мерж: мерж
реквест: реквесте
состар: состариться
программирован: программирование
поздн: поздно
больш: большой большого большое большая
продукт: продукт продуктов
сталкива: сталкивается сталкивался
проблем: проблемой проблемы
точн: точнее точно
трат: тратить
куч: кучу
сил: сил
оптимизац: оптимизацию
процесс: процесса процесс процессов
горазд: гораздо
прощ: проще
пробл: проблему
эмулятор: эмуляторов
ресурс: ресурсов ресурсы
простын: простыне
текст: текста
хоч: хочу
рассказа: рассказать
уменьш: уменьшили
прогон: прогона прогон
минут: минут
как: какие какую каких
истор: истории история
успешн: успешный
начина: начинается начинающие начинал начинающим
основ: основы
тип: типы типах типов
новичк: новичков новички
добр: добро доброго
пожалова: пожаловать
вероятн: вероятно
нача: начали
пут: путь
увлекательн: увлекательном
мир: мире мир
беспокойт: беспокойтесь
помоч: помочь
разобра: разобраться
различн: различных
современ: современной современных
практик: практике
независим: независимо
имеет: имеете имеет
материа: материал
расшир: расширить
умен: умения
существ: существует
множеств: множество
особен: особенности
преимуществ: преимущества
рассмотр: рассмотрим
распространен: распространенных
нул: нуля
личн: личный
карьер: карьера
индустр: индустрии
роадмэп: роадмэп
прош: прошу
сильн: сильно
пина: пинать
отлавлива: отлавливает
ошибк: ошибки
этап: этапах
рутин: рутинная рутины рутинных
ответствен: ответственная
получа: получают получать
программист: программисты
руб: руб
выш: выше
завис: зависит
становлен: становление
сам: самый самым
старт: старта
раст: расти
чист: чистая
информац: информацию информация
почерпнул: почерпнул
открыт: открытых
источник: источников
подума: подумал
ум: умею
программирова: программировать
астрономическ: астрономическую
зарплат: зарплату зарплаты
хочет: хочется
дума: думал думают думаю
устр: устроюсь
пойд: пойд
оказа: оказалось оказаться
полн: полно
так: таких таким такого
люд: людей
маловостребова: маловостребованы
вообщ: вообще
берут: берут
стаж: стаж
ров: ров
работодател: работодатель
ожида: ожидает
ближайш: ближайшем ближайшая
будущ: будущем
навык: навыки
ра: ра
охренен: охрененно
вырастут: вырастут
принос: приносить
огромн: огромную огромные
польз: пользу пользуется
фирм: фирме
дальн: дальнейшим
р: р
поэт: поэтому
ры: ры
получ: получив получить
либ: либо
настаива: настаивают
значительн: значительном
з: з
п: п
уход: уходят
конкурент: конкурентам
несмотр: несмотря
грустн: грустные
мысл: мысли мыслить
постав: поставил
изуч: изучить
продвинут: продвинутого
гайд: гайд
расскажут: расскажут
инструмент: инструментов инструмент
марсоход: марсоходов
конференц: конференции конференция
обычн: обычного
дня: дня
онлайнов: онлайновых
москв: москве
уда: удал
нног: нного
подключен: подключения
доклад: докладов
программ: программа программы
пришл: пришло пришли
показа: показать
описан: описания
вод: водится воды
освещ: освещены
сторон: стороны
нагрузочн: нагрузочного
оглавлен: оглавлении
найт: найти
блок: блок
перейт: перейти
сраз: сразу
вмест: вместо вместе
болтолог: болтологии
техническ: техническая
конкретик: конкретика
тестирова: тестировать
ускор: ускорить
многомодульн: многомодульном
хайпов: хайповый
очередн: очередных
абстрактн: абстрактных
рассужден: рассуждениях
увол: уволят
конкретн: конкретном
сравн: сравним
статическ: статическим
анализатор: анализатором
нюанс: нюансы
организац: организации
небольш: небольшой
представьт: представьте
вперв: впервые
единствен: единственным
чувствует: чувствуете
совершен: совершенно
беспомощн: беспомощным
затронут: затронуть
неочевидн: неочевидные
расширя: расширяем
туториа: туториал
фреймворк: фреймворков фреймворк
соответств: соответствия
требован: требованиям
возника: возникает
необходим: необходимость необходимо
реализова: реализовать реализовано
корректн: корректности
использован: использования использованию использованием
расширен: расширение расширений
линтер: линтера
общ: общие общего
создан: созданию создания
пример: примеров
назван: названий
функц: функций
налич: наличия
аннотац: аннотаций
автотест: автотест автотестов
яндекс: яндекс
практикум: практикум практикуме
привет: привет
стас: стас
наставник: наставник
курс: курсе
инженер: инженер
вед: веду
телегр: телеграм
кана: канал
нужн: нужны
мног: многие многое
автоматизатор: автоматизаторы
хотел: хотел
дел: деле делится
тем: тему
подробн: подробно
рассказыва: рассказывается рассказываю
применен: применение применению
паттерн: паттерна
написан: написании написание написанием
простеньк: простенький
экра: экран
авторизац: авторизации авторизация
язык: языке языка
един: единый единой
заглушечн: заглушечный
контур: контур
освобод: освободить освободившись
ир: ира
подел: поделиться
котор: которым
пользу: пользуемся
подготовк: подготовке
приход: приходится приходилось
писа: писать
похож: похожие
капл: капли
заглушк: заглушки заглушке
называ: называют
мок: моки
забот: заботиться забот
развернут: развернуть
понрав: понравиться
может: можете
удел: уделить
важн: важному важнее важным
разнош: разнош
рстны: рстные
хаотичн: хаотично
разв: разв
рнут: рнутые
окружен: окружении
дорог: дорогие
неэффективн: неэффективные
кажд: каждой
отдельн: отдельной
разбира: разбирается
случа: случае
одн: одна одним
времен: временем
накоплен: накоплении
критическ: критической
масс: массы
станов: становятся становится
фактическ: фактически
неподдержива: неподдерживаемыми
редк: редко
переиспольз: переиспользуются
тривиальн: тривиальны
способ: способом
неоптимальн: неоптимальными
представ: представить
рол: роли роль
самаритянин: самаритянина
разда: раздающего
коллег: коллегам
вряд: вряд
мотивир: мотивирует
приличн: прилично
некогд: некогда
отвлека: отвлекаться
разгруз: разгрузим
трудяг: трудягу
различ: различия различие
хот: хотите
доб: добиться
успех: успеха
быстр: быстро
изменя: изменяющемся
технолог: технологий технологии
постоя: постоянно постоянным
повыша: повышать
узнаваем: узнаваемость
целев: целевая
аудитор: аудитория аудиторию
равн: равной
мер: мере
устройств: устройствами устройств устройство
предоставлен: предоставления
высококачествен: высококачественных
программн: программных
обе: обеих
групп: групп
жизнен: жизненно
люб: любой
безупречн: безупречных
треб: требуется
спланирова: спланированный
изменен: изменением
мышлен: мышления
переход: переходом переходите
возраста: возрастает
реша: решающим
элемент: элементом
круглосуточн: круглосуточный
доступ: доступ доступом
лаборатор: лаборатории
облада: обладающие
облачн: облачным
использова: использовать
набор: набор
портативн: портативных
масштабирован: масштабирования
улучшен: улучшения
все: всей
схожест: схожести
сохраня: сохраняется
вид: видите вид
альф: альфа
банк: банк
ретроспектив: ретроспектива
смог: смог
правильн: правильно
департамент: департаментом
раскатыва: раскатываем
гигантск: гигантский
дашборд: дашборд
привяза: привязан
буквальн: буквально
ко: ко
позволя: позволяет
оцен: оценить
качеств: качество качеством качества
ива: иван
боклач: боклач
руководител: руководитель
направлен: направления
развит: развития развитием
экспертиз: экспертизы
центр: центре
координац: координации
занима: занимаюсь заниматься
метрик: метриками
стандартизац: стандартизацией
пиш: пишу
хвастовств: хвастовства
отнюд: отнюдь
привест: привести
дорожк: дорожка дорожке
главн: главное
крафт: крафтить
примерн: примерно
результат: результаты
нанимател: наниматели
бесплатн: бесплатной бесплатных бесплатные
задан: задании задания
спойлер: спойлер
никак: никак никаких
адекватн: адекватный
ищет: ищет
обновля: обновляю
месяц: месяц
л: л
гких: гких
репортаж: репортаж
техлид: техлида
рстку: рстку
архитектур: архитектуры
процессор: процессоров
бульварн: бульварное
чтив: чтиво
мем: мемов
фич: фичи
никола: николай
дильдин: дильдин
ведущ: ведущий
проапдейт: проапдейтили
хамелеон: хамелеон
созда: созданный создать
прошл: прошлом
модул: модулей
вошедш: вошедших
соста: состав
комплексн: комплексного
цифров: цифровой
экосистем: экосистемы
имен: именем
продолжа: продолжает
развива: развиваться
дружествен: дружественным
удобн: удобным
мощн: мощным
кат: кат
фрод: фрод фродом
вычисл: вычислить
слит: слить
бюджет: бюджет
нетолог: нетология
английск: английского
обма: обман
сфер: сфере
мошенничеств: мошенничества
бот: ботов
куплен: купленных
выда: выдают
реальн: реальную
недобросовестн: недобросовестные
маркетингов: маркетинговые
агентств: агентства
мастер: мастеры
рекламн: рекламные
площадк: площадки
агрегатор: агрегаторы
видим: видимость
деньг: деньги
заказчик: заказчика
идентификац: идентификация
аутентификац: аутентификация
разниц: разница
друз: друзья
форм: формы форм
ситуац: ситуацией
логин: логином
парол: паролем
завод: заводить
баг: баг багами
репорт: репорт
слов: слова
постара: постараться постараемся
максимальн: максимально
грамотн: грамотно
обознач: обозначить
разбер: разберем
поговор: поговорим
близк: близких
понят: понятиях
взаимосвяза: взаимосвязано
доступн: доступно
оста: осталось
подборк: подборка
дайджест: дайджест
арт: артем
генерир: генерирую
контент: контент
област: области
функциональн: функционального
создател: создателем
нескольк: нескольких
крупн: крупных
момент: момент
площадок: площадок
чат: чатов
аспект: аспектах
обучен: обучения обучение
общен: общения
взаимопомощ: взаимопомощи
появ: появилась
иде: идея
собра: собрать
борьб: борьбе
поисков: поисковые
машин: машинное
искусствен: искусственный
интеллект: интеллект
сезон: сезон
суперлайфхак: суперлайфхаков
нейросет: нейросетей
прочита: прочитав
сможет: сможет
облегч: облегчить
составлен: составление
документац: документации
минимум: минимуму
материал: материалов
сюд: сюда
вклад: вклад
ваканс: вакансии
аккаунт: аккаунт
войт: войти
регистрац: регистрация
раздел: разделы
публикац: публикации
хаб: хабы
сайт: сайта
документ: документы
соглашен: соглашение
конфиденциальн: конфиденциальность
корпоративн: корпоративный
медийн: медийная
реклам: реклама
нативн: нативные
образовательн: образовательные
стартап: стартапам
мегапроект: мегапроекты
дзен: дзен
настройк: настройка
поддержк: поддержка
вернут: вернуться
стар: старую
верс: версию
rss: rss
scarethebear: scarethebear
shift: shift
left: left
sergeyvyl: sergeyvyl
sportmast: sportmaster
lab: lab
e: e
commerc: commerce
io: ios
android: android
live: live
proqualitycommun: proqualitycommunity
api: api
ui: ui
hukumist: hukumister
tinkoff: tinkoff
ci: ci
test: test
impact: impact
analysi: analysis
nnowi: nnowi
metroid: metroid
python: python
phillennium: phillennium
heisenbug: heisenbug
spring: spring
jug: jug
ru: ru
group: group
flutter: flutter
maven: maven
chatgpt: chatgpt
dikobra: dikobra
qa: qa
dmitriizolotov: dmitriizolotov
lint: lint
otu: otus
kotlin: kotlin
studio: studio
wincomm: wincomm
senior: senior
indriv: indrive
pageobject: pageobject
java: java
milka: milka
root: root
samokat: samokat
tech: tech
sre: sre
ivanboklach: ivanboklach
appkod: appkode
alldmeat: alldmeat
dodo: dodo
engin: engineering engineer
nikolai: nikolay
dildin: dildin
qual: qual
ib: ibs
pro: pro
blognetolog: blognetology
fraud: fraud
c: c
artsiom: artsiom
rusau: rusau
obojealexand: obojealexander
ai: ai
machin: machine
learn: learning
milfgard: milfgard
leono: leono
olegchir: olegchir
gorodnya: gorodnya
paaladin: paaladin
nizkop: nizkopal
egoregor: egoregor
direviu: direvius
molechka: molechka
facebook: facebook
twitter: twitter
vk: vk
telegram: telegram
youtub: youtube
habr: habr
