хабр: хабр
откр: открыть
список: список
стат: стать статьи
автор: автором авторы авторов
поток: потоки
разработк: разработка
администрирован: администрирование
дизайн: дизайн
менеджмент: менеджмент
маркетинг: маркетинг
научпоп: научпоп
поиск: поиск
профил: профиль
обнов: обновить
час: часов
основ: основы основе
использован: использование использования
уровен: уровень
сложност: сложности
прост: простой
прочтен: прочтение
мин: мин
количеств: количество количества
просмотр: просмотров
песочниц: песочницы песочница
протокол: протокол протоколом протоколе протокола
связ: связи связь
поверх: поверх
соединен: соединения соединение соединением
предназначен: предназначенный
обм: обмена обмен
сообщен: сообщениями сообщения сообщение сообщений
браузер: браузером браузеров браузерами
веб: веб
сервер: сервером серверу сервера сервере сервер
использу: используя
постоя: постоянное постоянного
разниц: разница
клиент: клиент клиентом клиента клиенте клиентам клиенту
серверн: серверного
взаимодейств: взаимодействия
использ: используется используются использует
передач: передачи передачу передаче
дан: данных данными данные данном
нов: новый новых новое
позволя: позволяет позволяют
установ: установить
обеспеч: обеспечить
эффективн: эффективную эффективным
обеспечива: обеспечивает
низк: низкую низкая
задержк: задержку задержка
быстр: быстрый быстро быструю
отправля: отправлять отправляем отправляет
клиентск: клиентскую
сторон: сторону стороне
необходим: необходимости необходимо
запрос: запроса
несмотр: несмотря
явля: является
распространен: распространенным
использова: использоваться использовать
большинств: большинства
задач: задач
треб: требуют требует
базов: базовое базовый
фронт: фронте
созда: создать
объект: объект
указа: указав
адрес: адрес
котор: которому котором которым которое
хот: хотите
подключ: подключиться
может: можете
добав: добавить
обработчик: обработчики обработчик
событ: событий событие события
управлен: управления управление
обмен: обменом
пример: пример примера примере
установл: установлено
получ: получено
закрыт: закрыто закрытие
ошибк: ошибка ошибки
помощ: помощью
пакет: пакет пакеты
экземпляр: экземпляр
порт: порт
слуша: слушать
входя: входящие
как: какие
библиотек: библиотеки библиотеку
вмест: вместо
нативн: нативного нативные
предоставля: предоставляют
дополнительн: дополнительные дополнительной
возможн: возможности возможность возможные
автоматическ: автоматическое
переподключен: переподключение
поддержк: поддержку поддержки поддержка
стар: старых старую
механизм: механизмы механизм
безопасн: безопасности безопасностью безопасность безопасную
дела: делает
удобн: удобными удобный
реальн: реальных реального
проект: проектах проекты
отправ: отправить
установлен: установления
отправк: отправки отправку отправка отправке
получен: получения получении полученное
хук: хук хуки
отслеживан: отслеживания
списк: списка
подписк: подписки
добавлен: добавления
обработк: обработки обработка
форм: формы
переда: передать
функц: функцию функция функцией
обрабатыва: обрабатывать обрабатывает
наход: находится
файл: файле
определя: определяет определяем определять
действ: действия действие действий
подписыва: подписывается
диспетч: диспетчит
соответств: соответствующие
зависим: зависимости
определ: определить
редьюсер: редьюсеры
компонент: компонентах компонента
связа: связать
состоян: состояние состояния состоянием
выбор: выбора
диспетчинг: диспетчинга
генератор: генератор генератором
отслежива: отслеживает
вызыва: вызывает вызывается
сокет: сокет
необязательн: необязательный
колбэк: колбэк
успешн: успешной
обновля: обновляем
собствен: собственные
стандартн: стандартных
называ: называемый
пользовательск: пользовательские
определен: определенного
тип: типа
принима: принимает
качеств: качестве
ответ: ответа
префикс: префиксом
вывод: выводит
консол: консоль
допуска: допускают
разработчик: разработчики разработчиков разработчик
работ: работе работы работа
приложен: приложениях приложения приложений
допуст: допустить
ряд: ряд
ошибок: ошибок
включ: включая
неправильн: неправильная неправильно
закрыва: закрывается
привест: привести
утечк: утечке
ресурс: ресурсов
потер: потере потерь
памят: памяти
необработа: необработанные
возникнут: возникнуть
обработа: обработана
паден: падению
проблем: проблемы
конфигурац: конфигурацией
настроен: настроенное
сбо: сбоям
ненужн: ненужным
повторн: повторным
подключен: подключениям подключений
некорректн: некорректное
корректн: корректно
управля: управлять
избежа: избежать
непредсказуем: непредсказуемого
поведен: поведения
учитыва: учитывать
атак: атак атаки
межсайтов: межсайтовая
подделк: подделка
маршрутизац: маршрутизацию
уязвим: уязвимости
цел: целом
тщательн: тщательно
потенциальн: потенциальные
угроз: угрозы
надежн: надежность
плюс: плюсы
минус: минусы
двусторон: двусторонняя двустороннюю
полнодуплексн: полнодуплексную
инициирова: инициировать
люб: любой
момент: момент
реализац: реализации
реагирова: реагировать
изменен: изменения
взаимодействова: взаимодействовать
пользовател: пользователями
режим: режиме
работа: работает
мал: малое
масштабируем: масштабируемость масштабируемых
больш: большое большого
одновремен: одновременных
идеальн: идеальным
создан: создания
так: таких
онлайн: онлайн
игр: игры
чат: чат
мног: многие
поддержива: поддерживает поддерживается
защищен: защищенное
защит: защиту
простот: простота
легк: легко
интегрир: интегрируется
различн: различными
язык: языками языка
программирован: программирования
платформ: платформами
доступн: доступным
широк: широкого
круг: круга
фреймворк: фреймворки
интерфейс: интерфейс
настройк: настройки настройка
высок: высокая
нагрузк: нагрузка
сравнен: сравнении
тег: теги
хаб: хабы
голос: голосов
закладк: закладки
комментар: комментарии
карм: карма
рейтинг: рейтинг
леонид: леонид
публикац: публикации
лучш: лучшие
сутк: сутки
похож: похожие
истор: истории
ваканс: вакансий вакансии
аккаунт: аккаунт
войт: войти
регистрац: регистрация
раздел: разделы
новост: новости
компан: компании компаний
информац: информация
устройств: устройство
сайт: сайта
документ: документы
соглашен: соглашение
конфиденциальн: конфиденциальность
услуг: услуги
корпоративн: корпоративный
блог: блог
медийн: медийная
реклам: реклама
образовательн: образовательные
программ: программы
стартап: стартапам
спецпроект: спецпроекты
яндекс: яндекс
дзен: дзен
техническ: техническая
вернут: вернуться
верс: версию
leonidshishkin: leonidshishkin
websocket: websocket
react: react
redux: redux
saga: saga
rtk: rtk
queri: query
javascript: javascript
reactj: reactjs
tcp: tcp
http: http
onopen: onopen
onmessag: onmessage
onclos: onclose
onerror: onerror
const: const
socket: socket
ws: ws
localhost: localhost
function: function
consol: console
log: log
event: event events
data: data
error: error
messag: message messages
node: node
js: js
connect: connection connect connected
close: close
requir: require
wss: wss
server: server
port: port
incom: incoming
io: io
sockj: sockjs
disconnect: disconnect disconnected
import: import
usest: usestate
useeffect: useeffect
client: client
app: app
setmessag: setmessages
prevmessag: prevmessages
handlesubmit: handlesubmit
preventdefault: preventdefault
target: target
element: elements
emit: emit
return: return
div: div
ul: ul
map: map
index: index
li: li
kei: key
form: form
onsubmit: onsubmit
input: input
type: type
text: text
button: button
export: export
default: default
thunk: thunk
receiv: receive received
connectsocket: connectsocket
disconnectsocket: disconnectsocket
receivemessag: receivemessage
payload: payload
sendmessag: sendmessage
dispatch: dispatch
startlisten: startlistening
action: actions action
useselector: useselector
usedispatch: usedispatch
state: state
put: put
takeeveri: takeevery
effect: effects
yield: yield
watchsendmessag: watchsendmessage
send: send sending
createapi: createapi
fetchbasequeri: fetchbasequery
reduxj: reduxjs
toolkit: toolkit
messageapi: messageapi
reducerpath: reducerpath
basequeri: basequery
baseurl: baseurl
endpoint: endpoints
builder: builder
getmessag: getmessage
mutat: mutation
onquerystart: onquerystarted
newmessag: newmessage
invalid: invalidate
usegetmessagequeri: usegetmessagequery
usesendmessagemut: usesendmessagemutation
open: open
custom: custom
listmessag: listmessage
express: express
createserv: createserver
id: id
listen: listen listening
csrf: csrf
rout: routing
attack: attacks
ssl: ssl
tl: tls
xss: xss
signalr: signalr
net: net
middl: middle
frontend: frontend
develop: developer
facebook: facebook
twitter: twitter
vk: vk
telegram: telegram
youtub: youtube
habr: habr
