хабр: хабр
откр: открыть
список: список
стат: стать статьи статье статья статей
автор: автором авторы автор авторов
поток: потоки поток
разработк: разработка разработкой разработке разработки
администрирован: администрирование
дизайн: дизайн
менеджмент: менеджмент
маркетинг: маркетинг
научпоп: научпоп
поиск: поиск поиска
профил: профиль
обнов: обновить
рейтинг: рейтинг рейтинга
анализ: анализ анализа анализу
проектирован: проектирование
сист: систем систему
анализир: анализируй
проектир: проектируй
компан: компании компаниями компаниях компания компаний
подряд: подряд
скопирова: скопировать
ссылк: ссылку
показыва: показывать
нов: новые новый новых новая новой
лучш: лучшие лучший лучших
порог: порог порогом
уровен: уровень
сложност: сложности
прост: простой простейшие простую простые
средн: средний
сложн: сложный сложные
примен: применить
час: часа
аналитик: аналитиком аналитика аналитике аналитику аналитикам аналитики аналитик
дан: данных данные данная данными
прочтен: прочтение
мин: мин
количеств: количество
просмотр: просмотров
учебн: учебный
процесс: процесс процессах процессы процессов процессе процесса
карьер: карьера карьеры
индустр: индустрии
роадмэп: роадмэп
современ: современном современным
мир: мире
представля: представляет
одн: одну одним одно
востребова: востребованных востребованный
перспективн: перспективных
професс: профессий профессии
больш: большое больших
котор: которое которым которому
генерир: генерируется
использ: используется
различн: различных различной
отрасл: отраслях отраслей отрасли
став: ставит
организац: организациями организацию
задач: задачу задач задачах
высококвалифицирова: высококвалифицированных
специалист: специалистов специалистам
способн: способных
обрабатыва: обрабатывать
анализирова: анализировать
информац: информацию информации информация
рассмотр: рассмотрим
как: какие какими каких какого
требован: требования требованиями требованиям требований
предъявля: предъявляются
сфер: сфере
навык: навыками
знан: знаниями знание
облада: обладать
успешн: успешной
чита: читать читаются читали
дал: далее
голос: голосов
добав: добавить добавим
закладк: закладки
комментар: комментарии
новост: новости
апр: апр
использова: использовать использован
системн: системный системного системному системным
определен: определения
угроз: угроз угрозы
безопасн: безопасности безопасность безопасностью безопаснее безопасные
кратк: кратко
блог: блог
информацион: информационная
обзор: обзор
сам: самых самым
эффективн: эффективных
инструмент: инструментов инструмент
предприят: предприятие
распознава: распознавать
связа: связанные
использован: использование использования использованием использовании
помога: помогает
выявля: выявлять
уязвим: уязвимости
налажива: налаживать
контрол: контроль
повышен: повышения
уровн: уровня
устойчив: устойчивость устойчивости
автоматическ: автоматического
регулирован: регулирования
частотн: частотный частотные частотная
критер: критерий
михайлов: михайлова
математик: математика
инженерн: инженерные
систем: системы система системой
визуальн: визуальное визуальных
программирован: программирование
туториа: туториал
продолжа: продолжаем
лекц: лекции лекций
управлен: управлению управления управление
техническ: технических технической техническая
устройств: устройствах устройство
утс: утс
мгут: мгут
баума: баумана
н: н
козл: козлов
олег: олег
степанович: степанович
кафедр: кафедра
ядерн: ядерные ядерного
энергетическ: энергетические
установк: установки
факультет: факультета
машиностроен: машиностроения
огромн: огромное огромный
введен: введение
теор: теорию
математическ: математическое математическая
описан: описание описания
характеристик: характеристики характеристика
звен: звеньев звенья звено
амплитудн: амплитудно
фазов: фазовая фазовые
годограф: годограф
афчх: афчх
лах: лах
фчх: фчх
типов: типовые типовых
классификац: классификация
апериодическ: апериодическое
го: го
порядк: порядка
инерцион: инерционное инерционно
пример: примере пример
входн: входной
камер: камеры
реактор: реактора реакторе
колебательн: колебательное
дифференцир: дифференцирующее
форсир: форсирующее
интегрир: интегрирующее
замедлен: замедлением
изодромн: изодромное
изодр: изодром
минимальн: минимально
модел: модель моделей модели
кинетик: кинетики
нейтрон: нейтронов
точечн: точечном
нулев: нулевой нулевого
мощност: мощности
структурн: структурные
преобразован: преобразования
передаточн: передаточные
функц: функции
уравнен: уравнения
динамик: динамики
замкнут: замкнутых
сар: сар
понят: понятие
теорем: теорема
ляпунов: ляпунова
необходим: необходимые необходимо необходимости
услов: условия
линейн: линейных
линеаризова: линеаризованных
алгебраическ: алгебраический
гурвиц: гурвица
практик: практика
бэк: бэк
офисн: офисных
бирж: биржи биржа
кейс: кейс
центральн: центральной
част: частью часть части
явля: являются является
торгов: торговые торговому торговая торговой торговых
ядр: ядра ядру
происход: происходит
заявок: заявок
участник: участников участники участника
рынк: рынка
формир: формируется
верн: вернее
шлюз: шлюзу
подключа: подключаются
торг: торгов торгам торгах
тс: тс
могл: могла
работа: работать работаю работаем работал работает
начал: началу начале
ежедневн: ежедневной ежедневную
сесс: сессии
должн: должны
попаст: попасть
клиент: клиентов клиента клиенту
параметр: параметров
подключен: подключения
слов: словах
описа: описать описанное
долг: долгие
привед: приведем
допуст: допустим
пришл: пришла
мошенническ: мошенническая
фирм: фирма
выпуст: выпустила
облигац: облигации облигаций
куп: купили
вмест: вместо вместе
исполня: исполнять
обязательств: обязательства
держател: держателями
перевел: перевела
получен: полученные полученном
средств: средства
офшор: офшор
кайманов: каймановых
остров: островах
таков: такова
ответ: ответит ответ
сажа: сажать
тюрьм: тюрьму
избежа: избежать
подобн: подобных подобного
ситуац: ситуаций ситуации
допуск: допуске
финансов: финансовых
выполня: выполняются выполнять выполняете
проверк: проверки
прич: причем
зависим: зависимости
рол: роли
например: например
валютн: валютный
фондов: фондовый
рынок: рынок
дериватив: деривативов
проверя: проверять
эмитент: эмитента
состоя: состоять
разн: разных разным разными
шаг: шагов
набор: наборов набор
проверок: проверок
истор: истории историю история
практическ: практическое
архитектурн: архитектурные архитектурного
тем: темы тему
агрегат: агрегат
ограничен: ограниченный ограничения
контекст: контекст контексте
микросервис: микросервисе микросервисы микросервисов микросервис
перевод: перевод
пост: посте
расскаж: расскажу
использу: используем
уникальн: уникальные
бизнес: бизнес
создан: создания создание
руководств: руководства руководство
архитектур: архитектуре архитектуры архитектура
сосредоточ: сосредоточившись
трех: трех
общ: общих общие
паттерн: паттернах
реш: решить
создава: создавать
распредел: распределить распредел
наш: нашу
домен: доменную
логик: логику
сервис: сервисам сервису сервисе
вечн: вечная вечном
битв: битва
мнен: мнение
привет: привет
зовут: зовут
георг: георгий
ржавин: ржавин
процессн: процессным
архитектор: архитектором архитектора
руковож: руковожу
направлен: направлением
хотел: хотел
подискутирова: подискутировать
противостоян: противостоянии
подход: подходов подход
наход: находимся
выигрыва: выигрывает
перейд: перейдем
основн: основной
дискусс: дискуссии
сраз: сразу
оговор: оговорюсь
текущ: текущее
сражен: сражение
рассматрива: рассматривать
применительн: применительно
автоматизац: автоматизации
вопрос: вопросах вопрос
разбира: разбираюсь
построен: построение построения
формальн: формальных
приветств: приветствую
дорог: дорогие дорогих
читател: читатели читатель
алекс: алексей
федула: федулаев
позиц: позиции позиция
дела: делаю делать
продукт: продукты продукт продуктом продуктов
мотив: мотивам
мо: моего моем
выступлен: выступления
конференц: конференции
рассказыва: рассказывал
узна: узнаем узнать
нацел: нацелились
авиац: авиацию
песочниц: песочницы песочница
последн: последние последней последних
авиакомпан: авиакомпании
активн: активно
применя: применяют
блокчейн: блокчейн блокчейне блокчейна
алгоритм: алгоритмы
машин: машинного машинном машинное
обучен: обучения обучении обучение
решен: решения решений
помощ: помощью
технолог: технологии технологий
нног: нного
реестр: реестра
созда: создают создали создан создал
хранен: хранения
передач: передачи
принят: принятия
авиасообщен: авиасообщения
треб: требуются требуют
колоссальн: колоссальные
вычислительн: вычислительные
высокопроизводительн: высокопроизводительные
кластер: кластеры
баз: базе баз базами базы
графическ: графических
процессор: процессоров
авиаотрасл: авиаотрасль
позвол: позволить
инфраструктур: инфраструктуры
проект: проектов проекты
год: годы годится годов
оказа: оказалась
важн: важных важно важной
игрок: игроков
и: ии
выпуск: выпуск выпуске
призва: призван
устран: устранить
озерн: озерным озерный озерное
хранилищ: хранилищем хранилище
ран: ранее
известн: известная
объяв: объявила
верс: версии версию
унифицирова: унифицированной
аналитическ: аналитической
платформ: платформы
реализова: реализовано реализовали реализован
множеств: множество
возможн: возможностей возможность возможности
пакетн: пакетной
обработк: обработки
работ: работы работу работе работая работа
реальн: реальном
включ: включая
предварительн: предварительного
ввод: ввода
озер: озеро озера
дом: дом
объединя: объединяет
преимуществ: преимущества преимуществ
одновремен: одновременно
постро: построить
способ: способ способы
посмотрет: посмотреть
глаз: глазами
пользовател: пользователя пользователю пользователей
веб: веб
корол: королев
директор: директор
карт: карту
пут: пути
разобра: разобраться
меша: мешает
ваш: вашим вашему
мысл: мысли
эмоц: эмоции
вызыва: вызывает
интерфейс: интерфейс интерфейса
вс: вс
улучш: улучшить
хорош: хороший
поня: понять
сдела: сделать
поэт: поэтому
знат: знать
поеха: поехали
правильн: правильных
осн: основ
зна: знаем
достига: достигает
состоян: состояния
гиперр: гиперроста
лет: летит
черт: чертям
газиллион: газиллионы
микрофронтенд: микрофронтендов
д: д
команд: команды
разработчик: разработчиков разработчикам разработчику
появля: появляются
кварта: квартал
принима: принимаем
люд: людей
либ: либо
прежд: прежде
разрабатыва: разрабатывали разрабатываемые
браузерн: браузерную
игр: игру игра
взгляд: взгляд
сторон: стороны
мног: многие многих
всяческ: всячески
пыта: пытаются
мотивирова: мотивировать
удержива: удерживать
сотрудник: сотрудников
слыш: слышим
геймификац: геймификации
позволя: позволяет
значительн: значительно
показател: показатели
вовлечен: вовлеченности
повыс: повысить
продаж: продажи
заинтересова: заинтересовать
преврат: превратить
рутин: рутину
увлекательн: увлекательный увлекательная
игров: игровой игрового
приня: приняли
участ: участие
так: такого таких таким
приложен: приложения приложений
антон: антон
руководител: руководитель
комитет: комитета
опыт: опыте опыта
точк: точки
зрен: зрения
технологическ: технологических
особен: особенностей
реализац: реализации
нестандартн: нестандартных
элемент: элементов элементы элемент
подел: поделюсь
пагинац: пагинации
компонент: компонент
кнопк: кнопки
составн: составной
анимац: анимацию
гибкост: гибкости
гибк: гибкие гибкими
методолог: методологии методология методологиями
заня: заняли
мест: место
программн: программного
обеспечен: обеспечения
эйфор: эйфория
свобод: свободы
самоорганизац: самоорганизации
постепен: постепенно
рассея: рассеялась
выступ: выступили
подводн: подводные
камн: камни
неудобн: неудобные
пружин: пружины
подтверд: подтвердилось
японск: японского
сборочн: сборочного
конвейер: конвейера
манифест: манифесте
половин: половину
слев: слева
концептуальн: концептуальные
противореч: противоречия
заказчик: заказчиком заказчиков
исчезл: исчезли
очевидн: очевидно
нужн: нужна
мар: мар
быстр: быстрее
плох: плохо
детекц: детекция детекции
разладок: разладок
яндекс: яндекс
высок: высокая
производительн: производительность
люб: любую любого
высоконагружен: высоконагруженную
ежесекундн: ежесекундно
проход: проходит проходил
трафик: трафика
релиз: релизы
хотфикс: хотфиксы
атак: атаки
невалидн: невалидные
ухудша: ухудшающие
эксперимент: эксперименты
событ: события
привест: привести
проблем: проблемам проблемы проблемой
влия: влияют
терп: терпят
задержек: задержек
провест: провести
аналог: аналогию
заболел: заболели
минимизирова: минимизировать
побочн: побочные
эффект: эффекты
выздоровлен: выздоровления
баннерн: баннерная
крутилк: крутилка
маркетплейс: маркетплейс
онлайн: онлайн
доставк: доставка
пицц: пиццы
владимир: владимир
точилин: точилин
групп: группе
развит: развития
рекламн: рекламных
стабильн: стабильности
сво: своим
коллег: коллегой
александр: александром
самусенк: самусенко
прод: проде
отдельн: отдельные
нагрузк: нагрузка
превыша: превышает
интересн: интересно интересна
прочита: прочитать
менеджер: менеджерам
схем: схема схемы
пол: полей
фасетн: фасетного
фильтр: фильтра
интернет: интернет
магазин: магазине
сайт: сайтов сайта
поисков: поисковые
добр: доброго
суток: суток
самоучк: самоучка
получа: получал получается получаются
образован: образования
программист: программистом
специализирова: специализированных
курс: курсов
акцентир: акцентирую
вниман: внимание внимания
пониман: понимание понимании
претенд: претендует
статус: статус
профессиональн: профессионального
текст: тексту текст
панаце: панацея
выраз: выразиться
основа: основано
личн: личном личного
структур: структуры структурой
документ: документов документы
ориентирова: ориентированной
пришел: пришел
изучен: изучении
рассчита: рассчитана
новичк: новичков
представлен: представления
ко: коей
кажд: каждому
специальн: специальное
значен: значение значения значений
обозначен: обозначения
отсутств: отсутствия отсутствие
отлича: отличается
пуст: пустой
строк: строки
означа: означает означало
ячейк: ячейке
таблиц: таблицы таблицах таблице
появлен: появления
длин: длинна
х: х
камерер: камерер
р: р
бойд: бойд
предлож: предложили
реляцион: реляционную реляционной
полн: полной полная полного
зам: замены замена
иерархическ: иерархических
сетев: сетевых
актуальн: актуальны
предполага: предполагала
первоначальн: первоначально
интегральн: интегральный
качеств: качестве
тип: типа
цел: целого целой целей
числ: числа
неизвестн: неизвестно
разработа: разработана
маркер: маркер
указыва: указывает
столбц: столбце
образ: образом
неопределен: неопределенное неопределенный
некотор: некоторые
операц: операцию операции
содержа: содержащем
результат: результат результатам
привод: приводить приводят приводит
нежелательн: нежелательным
непредсказуем: непредсказуемое
поведен: поведение
понима: понимать
обязательн: обязательно
указан: указание
вычислен: вычислений
отметк: отметки
замен: заменить
искусствен: искусственный
интеллект: интеллект
сможет: сможет
дает: дает
взаимодейств: взаимодействия
чат: чатом
предлага: предлагается
разбор: разбор
недостатк: недостатков
рабоч: рабочих
кросс: кросс
функциональн: функциональные функциональных
переход: переходы переходить
миф: миф
реальност: реальность
ростелек: ростелеком
ман: манит
ит: ит
низк: низким
вхожден: вхождения
выход: выходят
труд: труда
начина: начинается начинающих
гонк: гонка
прокачк: прокачку
компетенц: компетенций
экспертн: экспертный
рост: рост
миграц: миграцию
обратн: обратно
тимлидерств: тимлидерство
продолжительн: продолжительная продолжительной
прошел: прошел
близок: близок
прохожден: прохождению
почива: почивать
лавр: лаврах
след: следующий
предел: пределы
сет: сети
может: можете
найт: найти
мертв: мертв
нуж: нужен
протяжен: протяжении
совершен: совершенно
жизнен: жизненным
цикл: циклом цикла
виж: вижу
попытк: попытки
ускорен: ускорения
счет: счет
отказ: отказа
подава: подаваемые
прекрасн: прекрасными
аргумент: аргументами
переписыва: переписывать
отвеча: отвечает
никт: никто
знает: знает
нормальн: нормального
абсолютн: абсолютно
элементарн: элементарнейшие
изменен: изменения
запуск: запуску
перечисл: перечислить
пробл: проблем
читаем: читаемость
подготовк: подготовка
документац: документации
чтен: чтение чтения
фт: фт
занят: занятие
непрост: непростое
восприят: восприятие
концентрац: концентрации
расход: расходуют
главн: главный
ресурс: ресурс
шник: шника
спотыка: спотыкается
увяза: увязает
перечитыва: перечитывает
трат: тратя
писател: писателей
помогут: помогут
легч: легче
ориентирован: ориентирования
сюд: сюда
вклад: вклад
ваканс: вакансий вакансии
аккаунт: аккаунт
войт: войти
регистрац: регистрация
раздел: разделы
хаб: хабы
соглашен: соглашение
конфиденциальн: конфиденциальность
услуг: услуги
корпоративн: корпоративный
медийн: медийная
реклам: реклама
нативн: нативные
образовательн: образовательные
программ: программы
стартап: стартапам
спецпроект: спецпроекты
дзен: дзен
настройк: настройка
язык: языка
поддержк: поддержка
вернут: вернуться
стар: старую
rss: rss
badcasedaili: badcasedaily
python: python
sql: sql
maxrokatanski: maxrokatansky
otu: otus
petuhoff: petuhoff
matlab: matlab
moscow: moscow
exchang: exchange
bpm: bpms
moex: moex
match: matching
order: order
log: log
kyc: kyc
ddd: ddd
auguri: augury
vimagik: vimagik
high: high
code: code
glowbyt: glowbyte
busi: business
process: process
manag: management
xffd: xffd
bimeist: bimeister
devsecop: devsecops
highload: highload
victormartynov: victormartynov
blockchain: blockchain
ai: ai
celerdata: celerdata
starrock: starrocks
lakehous: lakehouse
shiwalol: shiwalol
cjm: cjm
agima: agima
architectsimbirsoft: architectsimbirsoft
frontend: frontend
simbirsoft: simbirsoft
javascript: javascript
vuej: vuejs
model: model
servic: service
store: store
g: g
card: card
list: list
dosergeyv: dosergeyv
add: add
innov: innovative
peopl: people
agil: agile
scrum: scrum
kanban: kanban
tochillin: tochillin
realtim: realtime
catboost: catboost
ddo: ddos
rp: rps
yooooooman: yooooooman
elasticsearch: elasticsearch
e: e
commerc: commerce
es: es
nosql: nosql
null: null
big: big
data: data
engin: engineering
d: d
chamberlin: chamberlin
r: r
boyc: boyce
ivankhar: ivankhar
chatgpt: chatgpt
mar: mar
s: s
alexgfrei: alexgfrei
uml: uml
design: design
time: time
market: market
dovolnehonek: dovolnehonek
nmivan: nmivan
alonecod: alonecoder
tangro: tangro
olegbunin: olegbunin
man: man
zzeng: zzeng
cloud: cloud
dmitryspb: dmitryspb
ua: ua
host: hosting
facebook: facebook
twitter: twitter
vk: vk
telegram: telegram
youtub: youtube
habr: habr
