хабр: хабр
откр: открыть
список: список
стат: стать статьи
автор: автором авторы авторов
поток: потоки
разработк: разработка разработкой
администрирован: администрирование
дизайн: дизайн
менеджмент: менеджмент
маркетинг: маркетинг
научпоп: научпоп
поиск: поиск
профил: профиль
обнов: обновить
добав: добавить
компан: компанию компании компаний компания
новост: новости
хаб: хабы
назван: название
сортировк: сортировка
рейтинг: рейтинг
подписчик: подписчики
хостинг: хостинг
скидк: скидка
код: коду
пишет: пишет
читальн: читальный
зал: зал
сдела: сделай
научн: научно
популярн: популярное
электроник: электроника электроники
начина: начинающих
системн: системное
облачн: облачная облачные
платформ: платформа
разработчик: разработчиков
бизнес: бизнеса
истор: история
инфраструктур: инфраструктура
компьютерн: компьютерное
желез: железо
гаджет: гаджеты
производств: производство
технолог: технологии
объединя: объединяют
машин: машинное
обучен: обучение
сервис: сервисы сервисов
цифров: цифровые
навык: навыки
ведущ: ведущих ведущая
эксперт: экспертов
программирован: программирование
тестирован: тестирование
веб: веб
яндекс: яндекс
дела: делаем делать
высок: высокая
производительн: производительность
интерфейс: интерфейсы
крупн: крупнейшее крупнейший
русскоязычн: русскоязычное
сообществ: сообщество сообществом сообщества
искусствен: искусственный
интеллект: интеллект
виртуальн: виртуальные
выделен: выделенные
сервер: серверы
дц: дц
москв: москве
информацион: информационная
безопасн: безопасность
будущ: будущее
гк: гк
лан: ланит
многопрофильн: многопрофильная
групп: группа
ит: ит
рф: рф
управлен: управление
персонал: персоналом
карьер: карьера карьеру
индустр: индустрии
проект: проектами проекты
рассказыва: рассказываем
стро: строить
лайфхак: лайфхаки
гик: гиков
эмиграц: эмиграция
урбанизм: урбанизм
оборудован: оборудование
автоматизац: автоматизации
мониторинг: мониторинга
умн: умный
дом: дом
интернет: интернет
вещ: вещей
инженерн: инженерные
систем: системы
зам: замена
мозг: мозг
сетев: сетевые
экосистем: экосистема
развит: развития
люд: людей
вовлечен: вовлеченных
контент: контент
социальн: социальные
сет: сети
сбер: сбер
меня: меняющие
мир: мир
флант: флант
обслуживан: обслуживание
сложн: сложном
мобильн: мобильных
приложен: приложений
сист: систем
лаборатор: лаборатория
касперск: касперского
лов: ловим
вирус: вирусы
исследу: исследуем
угроз: угрозы
спаса: спасаем
стар: старое старую
ноутбук: ноутбуки
издательск: издательский
питер: питер
профессиональн: профессиональная
литератур: литература
алгоритм: алгоритмы
ооп: ооп
интегратор: интегратор
решен: решений
продукт: продуктом
конференц: конференции
стрем: стремимся
лучш: лучший
росс: россии
сюд: сюда
фильтр: фильтр
аккаунт: аккаунт
войт: войти
регистрац: регистрация
раздел: разделы
песочниц: песочница
информац: информация
устройств: устройство
сайт: сайта
документ: документы
соглашен: соглашение
конфиденциальн: конфиденциальность
услуг: услуги
корпоративн: корпоративный
блог: блог
медийн: медийная
реклам: реклама
нативн: нативные
образовательн: образовательные
программ: программы
стартап: стартапам
спецпроект: спецпроекты
дзен: дзен
настройк: настройка
язык: языка
техническ: техническая
поддержк: поддержка
вернут: вернуться
верс: версию
ruvd: ruvds
vd: vds
vp: vps
habr: habr
dii: diy
timeweb: timeweb
cloud: cloud
javascript: javascript
selectel: selectel
vk: vk
big: big
data: data
devop: devops
tarantool: tarantool
otu: otus
java: java
python: python
open: open
sourc: source
scienc: science
natur: natural
languag: language
process: processing
mine: mining
firstvd: firstvds
getmatch: getmatch
wiren: wiren
board: board
evateam: evateam
jira: jira
confluenc: confluence
servic: service technologies
manag: management
atlassian: atlassian
kubernet: a
tinkoff: kubernetes
s: tinkoff
android: s
agima: android
digit: agima
ozon: digital
tech: ozon
e: tech
commerc: e
web: commerce
develop: web
softwar: development
hardwar: software
design: hardware
usabl: design
advertis: usability
market: advertisement
mass: marketing
media: mass
consult: media
support: consulting
hr: support
profit: hr
organ: profit
optim: organizations
produc: optimization
multimedia: producing
content: multimedia
telecommun: content
domain: telecommunications
host: domains
search: hosting
engin: search
mobil: engines
technolog: mobile
game: services
entertain: games
inform: entertainment
secur: information
facebook: security
twitter: facebook
telegram: twitter
youtub: telegram
